,n_cluster,year_month,num_crimes,violent_cm,theft_cm,m_score
0,Cluster 1,2011-01,55,4,51,3.7727272727272734
1,Cluster 1,2011-02,70,3,67,21.659090909090907
2,Cluster 1,2011-03,87,2,85,28.977272727272727
3,Cluster 1,2011-04,59,4,55,3.886363636363633
4,Cluster 1,2011-05,104,8,96,39.727272727272734
5,Cluster 1,2011-06,105,5,100,38.06818181818181
6,Cluster 1,2011-07,104,11,93,35.477272727272734
7,Cluster 1,2011-08,105,0,105,37.38636363636364
8,Cluster 1,2011-09,68,2,66,0.6363636363636402
9,Cluster 1,2011-10,87,2,85,13.068181818181813
10,Cluster 1,2011-11,96,4,92,27.63636363636364
11,Cluster 1,2011-12,81,3,78,11.431818181818187
12,Cluster 1,2012-01,69,3,66,1.5454545454545467
13,Cluster 1,2012-02,61,2,59,6.93181818181818
14,Cluster 1,2012-03,67,4,63,10.136363636363633
15,Cluster 1,2012-04,68,4,64,9.795454545454547
16,Cluster 1,2012-05,82,3,79,15.431818181818187
17,Cluster 1,2012-06,58,4,54,-9.795454545454547
18,Cluster 1,2012-07,87,2,85,13.818181818181813
19,Cluster 1,2012-08,81,3,78,3.3409090909090935
20,Cluster 1,2012-09,80,7,73,9.840909090909093
21,Cluster 1,2012-10,105,4,101,30.38636363636364
22,Cluster 1,2012-11,116,3,113,50.56818181818181
23,Cluster 1,2012-12,89,1,88,21.340909090909093
24,Cluster 1,2013-01,58,1,57,-5.727272727272727
25,Cluster 1,2013-02,55,1,54,4.204545454545453
26,Cluster 1,2013-03,79,3,76,20.522727272727273
27,Cluster 1,2013-04,82,5,77,20.545454545454547
28,Cluster 1,2013-05,79,4,75,6.63636363636364
29,Cluster 1,2013-06,94,3,91,21.727272727272734
30,Cluster 1,2013-07,79,2,77,6.681818181818187
31,Cluster 1,2013-08,82,6,76,7.61363636363636
32,Cluster 1,2013-09,98,4,94,21.88636363636364
33,Cluster 1,2013-10,75,0,75,0.5454545454545467
34,Cluster 1,2013-11,89,3,86,22.022727272727266
35,Cluster 1,2013-12,72,4,68,3.3863636363636402
36,Cluster 1,2014-01,77,3,74,11.977272727272734
37,Cluster 1,2014-02,60,1,59,10.045454545454547
38,Cluster 1,2014-03,74,4,70,18.227272727272727
39,Cluster 1,2014-04,76,2,74,13.840909090909093
40,Cluster 1,2014-05,60,2,58,-11.86363636363636
41,Cluster 1,2014-06,63,4,59,-13.068181818181813
42,Cluster 1,2014-07,83,3,80,-1.1590909090909065
43,Cluster 1,2014-08,134,3,131,47.0
44,Cluster 1,2014-09,113,4,109,28.88636363636364
45,Cluster 1,2014-10,89,5,84,1.9090909090909065
46,Cluster 1,2014-11,73,3,70,-2.431818181818187
47,Cluster 1,2014-12,64,2,62,-5.5
48,Cluster 1,2015-01,53,3,50,-12.272727272727266
49,Cluster 1,2015-02,36,1,35,-6.9090909090909065
50,Cluster 1,2015-03,51,1,50,-5.25
51,Cluster 1,2015-04,49,2,47,-17.545454545454547
52,Cluster 1,2015-05,82,2,80,6.0909090909090935
53,Cluster 1,2015-06,95,6,89,17.704545454545453
54,Cluster 1,2015-07,102,4,98,19.5
55,Cluster 1,2015-08,78,3,75,-0.568181818181813
56,Cluster 1,2015-09,99,3,96,25.181818181818187
57,Cluster 1,2015-10,64,1,63,-13.227272727272734
58,Cluster 1,2015-11,88,1,87,16.909090909090907
59,Cluster 1,2015-12,90,2,88,13.61363636363636
60,Cluster 10,2011-01,13,0,13,-38.22727272727273
61,Cluster 10,2011-02,16,0,16,-32.34090909090909
62,Cluster 10,2011-03,17,0,17,-41.02272727272727
63,Cluster 10,2011-04,13,1,12,-42.11363636363637
64,Cluster 10,2011-05,19,0,19,-45.272727272727266
65,Cluster 10,2011-06,31,0,31,-35.93181818181819
66,Cluster 10,2011-07,30,0,30,-38.522727272727266
67,Cluster 10,2011-08,36,1,35,-31.61363636363636
68,Cluster 10,2011-09,19,0,19,-48.36363636363636
69,Cluster 10,2011-10,32,2,30,-41.93181818181819
70,Cluster 10,2011-11,30,1,29,-38.36363636363636
71,Cluster 10,2011-12,25,0,25,-44.56818181818181
72,Cluster 10,2012-01,27,0,27,-40.45454545454545
73,Cluster 10,2012-02,17,1,16,-37.06818181818182
74,Cluster 10,2012-03,22,0,22,-34.86363636363637
75,Cluster 10,2012-04,13,0,13,-45.20454545454545
76,Cluster 10,2012-05,19,0,19,-47.56818181818181
77,Cluster 10,2012-06,28,0,28,-39.79545454545455
78,Cluster 10,2012-07,36,0,36,-37.18181818181819
79,Cluster 10,2012-08,25,0,25,-52.65909090909091
80,Cluster 10,2012-09,21,1,20,-49.15909090909091
81,Cluster 10,2012-10,26,0,26,-48.61363636363636
82,Cluster 10,2012-11,22,0,22,-43.43181818181819
83,Cluster 10,2012-12,16,0,16,-51.65909090909091
84,Cluster 10,2013-01,19,0,19,-44.72727272727273
85,Cluster 10,2013-02,11,0,11,-39.79545454545455
86,Cluster 10,2013-03,28,0,28,-30.477272727272727
87,Cluster 10,2013-04,27,0,27,-34.45454545454545
88,Cluster 10,2013-05,48,0,48,-24.36363636363636
89,Cluster 10,2013-06,20,0,20,-52.272727272727266
90,Cluster 10,2013-07,31,0,31,-41.31818181818181
91,Cluster 10,2013-08,32,0,32,-42.38636363636364
92,Cluster 10,2013-09,37,0,37,-39.11363636363636
93,Cluster 10,2013-10,30,0,30,-44.45454545454545
94,Cluster 10,2013-11,34,0,34,-32.977272727272734
95,Cluster 10,2013-12,43,0,43,-25.61363636363636
96,Cluster 10,2014-01,31,0,31,-34.022727272727266
97,Cluster 10,2014-02,6,0,6,-43.95454545454545
98,Cluster 10,2014-03,19,0,19,-36.77272727272727
99,Cluster 10,2014-04,26,0,26,-36.15909090909091
100,Cluster 10,2014-05,27,0,27,-44.86363636363636
101,Cluster 10,2014-06,28,1,27,-48.06818181818181
102,Cluster 10,2014-07,19,0,19,-65.1590909090909
103,Cluster 10,2014-08,38,2,36,-49.0
104,Cluster 10,2014-09,34,0,34,-50.11363636363636
105,Cluster 10,2014-10,44,1,43,-43.09090909090909
106,Cluster 10,2014-11,32,0,32,-43.43181818181819
107,Cluster 10,2014-12,17,0,17,-52.5
108,Cluster 10,2015-01,8,0,8,-57.272727272727266
109,Cluster 10,2015-02,12,0,12,-30.909090909090907
110,Cluster 10,2015-03,11,0,11,-45.25
111,Cluster 10,2015-04,35,0,35,-31.545454545454547
112,Cluster 10,2015-05,30,0,30,-45.90909090909091
113,Cluster 10,2015-06,16,0,16,-61.29545454545455
114,Cluster 10,2015-07,28,0,28,-54.5
115,Cluster 10,2015-08,10,0,10,-68.56818181818181
116,Cluster 10,2015-09,24,0,24,-49.81818181818181
117,Cluster 10,2015-10,22,0,22,-55.227272727272734
118,Cluster 10,2015-11,27,1,26,-44.09090909090909
119,Cluster 10,2015-12,28,0,28,-48.38636363636364
120,Cluster 11,2011-01,45,1,44,-6.227272727272727
121,Cluster 11,2011-02,30,2,28,-18.340909090909093
122,Cluster 11,2011-03,29,0,29,-29.022727272727273
123,Cluster 11,2011-04,38,1,37,-17.113636363636367
124,Cluster 11,2011-05,47,0,47,-17.272727272727266
125,Cluster 11,2011-06,46,0,46,-20.931818181818187
126,Cluster 11,2011-07,35,1,34,-33.522727272727266
127,Cluster 11,2011-08,58,1,57,-9.61363636363636
128,Cluster 11,2011-09,52,0,52,-15.36363636363636
129,Cluster 11,2011-10,56,2,54,-17.931818181818187
130,Cluster 11,2011-11,50,2,48,-18.36363636363636
131,Cluster 11,2011-12,48,0,48,-21.568181818181813
132,Cluster 11,2012-01,55,0,55,-12.454545454545453
133,Cluster 11,2012-02,62,2,60,7.93181818181818
134,Cluster 11,2012-03,28,0,28,-28.863636363636367
135,Cluster 11,2012-04,44,2,42,-14.204545454545453
136,Cluster 11,2012-05,39,0,39,-27.568181818181813
137,Cluster 11,2012-06,44,0,44,-23.795454545454547
138,Cluster 11,2012-07,39,0,39,-34.18181818181819
139,Cluster 11,2012-08,49,2,47,-28.659090909090907
140,Cluster 11,2012-09,33,0,33,-37.15909090909091
141,Cluster 11,2012-10,72,0,72,-2.6136363636363598
142,Cluster 11,2012-11,51,0,51,-14.431818181818187
143,Cluster 11,2012-12,48,0,48,-19.659090909090907
144,Cluster 11,2013-01,56,0,56,-7.727272727272727
145,Cluster 11,2013-02,51,2,49,0.20454545454545325
146,Cluster 11,2013-03,75,0,75,16.522727272727273
147,Cluster 11,2013-04,58,1,57,-3.4545454545454533
148,Cluster 11,2013-05,74,0,74,1.6363636363636402
149,Cluster 11,2013-06,55,1,54,-17.272727272727266
150,Cluster 11,2013-07,59,2,57,-13.318181818181813
151,Cluster 11,2013-08,48,0,48,-26.38636363636364
152,Cluster 11,2013-09,61,1,60,-15.11363636363636
153,Cluster 11,2013-10,67,0,67,-7.454545454545453
154,Cluster 11,2013-11,75,2,73,8.022727272727266
155,Cluster 11,2013-12,43,0,43,-25.61363636363636
156,Cluster 11,2014-01,56,1,55,-9.022727272727266
157,Cluster 11,2014-02,46,1,45,-3.9545454545454533
158,Cluster 11,2014-03,44,0,44,-11.772727272727273
159,Cluster 11,2014-04,70,0,70,7.8409090909090935
160,Cluster 11,2014-05,57,0,57,-14.86363636363636
161,Cluster 11,2014-06,55,0,55,-21.068181818181813
162,Cluster 11,2014-07,68,1,67,-16.159090909090907
163,Cluster 11,2014-08,60,2,58,-27.0
164,Cluster 11,2014-09,41,0,41,-43.11363636363636
165,Cluster 11,2014-10,58,1,57,-29.090909090909093
166,Cluster 11,2014-11,53,1,52,-22.431818181818187
167,Cluster 11,2014-12,50,0,50,-19.5
168,Cluster 11,2015-01,44,1,43,-21.272727272727266
169,Cluster 11,2015-02,49,1,48,6.0909090909090935
170,Cluster 11,2015-03,53,1,52,-3.25
171,Cluster 11,2015-04,36,0,36,-30.545454545454547
172,Cluster 11,2015-05,62,0,62,-13.909090909090907
173,Cluster 11,2015-06,65,1,64,-12.295454545454547
174,Cluster 11,2015-07,63,0,63,-19.5
175,Cluster 11,2015-08,36,0,36,-42.56818181818181
176,Cluster 11,2015-09,55,1,54,-18.818181818181813
177,Cluster 11,2015-10,80,0,80,2.7727272727272663
178,Cluster 11,2015-11,46,1,45,-25.090909090909093
179,Cluster 11,2015-12,62,1,61,-14.38636363636364
180,Cluster 12,2011-01,19,0,19,-32.22727272727273
181,Cluster 12,2011-02,22,0,22,-26.340909090909093
182,Cluster 12,2011-03,26,0,26,-32.02272727272727
183,Cluster 12,2011-04,25,0,25,-30.113636363636367
184,Cluster 12,2011-05,17,0,17,-47.272727272727266
185,Cluster 12,2011-06,17,0,17,-49.93181818181819
186,Cluster 12,2011-07,17,0,17,-51.522727272727266
187,Cluster 12,2011-08,24,0,24,-43.61363636363636
188,Cluster 12,2011-09,20,0,20,-47.36363636363636
189,Cluster 12,2011-10,19,0,19,-54.93181818181819
190,Cluster 12,2011-11,22,0,22,-46.36363636363636
191,Cluster 12,2011-12,15,1,14,-54.56818181818181
192,Cluster 12,2012-01,11,0,11,-56.45454545454545
193,Cluster 12,2012-02,12,0,12,-42.06818181818182
194,Cluster 12,2012-03,18,0,18,-38.86363636363637
195,Cluster 12,2012-04,18,1,17,-40.20454545454545
196,Cluster 12,2012-05,16,1,15,-50.56818181818181
197,Cluster 12,2012-06,14,0,14,-53.79545454545455
198,Cluster 12,2012-07,12,0,12,-61.18181818181819
199,Cluster 12,2012-08,9,0,9,-68.6590909090909
200,Cluster 12,2012-09,23,1,22,-47.15909090909091
201,Cluster 12,2012-10,12,0,12,-62.61363636363636
202,Cluster 12,2012-11,14,0,14,-51.43181818181819
203,Cluster 12,2012-12,13,0,13,-54.65909090909091
204,Cluster 12,2013-01,18,0,18,-45.72727272727273
205,Cluster 12,2013-02,20,0,20,-30.795454545454547
206,Cluster 12,2013-03,12,1,11,-46.47727272727273
207,Cluster 12,2013-04,10,1,9,-51.45454545454545
208,Cluster 12,2013-05,21,0,21,-51.36363636363636
209,Cluster 12,2013-06,19,1,18,-53.272727272727266
210,Cluster 12,2013-07,11,0,11,-61.31818181818181
211,Cluster 12,2013-08,15,2,13,-59.38636363636364
212,Cluster 12,2013-09,29,1,28,-47.11363636363636
213,Cluster 12,2013-10,27,0,27,-47.45454545454545
214,Cluster 12,2013-11,15,1,14,-51.977272727272734
215,Cluster 12,2013-12,13,0,13,-55.61363636363636
216,Cluster 12,2014-01,12,0,12,-53.022727272727266
217,Cluster 12,2014-02,7,0,7,-42.95454545454545
218,Cluster 12,2014-03,16,0,16,-39.77272727272727
219,Cluster 12,2014-04,16,1,15,-46.15909090909091
220,Cluster 12,2014-05,21,0,21,-50.86363636363636
221,Cluster 12,2014-06,17,1,16,-59.06818181818181
222,Cluster 12,2014-07,23,1,22,-61.15909090909091
223,Cluster 12,2014-08,22,1,21,-65.0
224,Cluster 12,2014-09,20,1,19,-64.11363636363636
225,Cluster 12,2014-10,31,0,31,-56.09090909090909
226,Cluster 12,2014-11,12,0,12,-63.43181818181819
227,Cluster 12,2014-12,18,1,17,-51.5
228,Cluster 12,2015-01,16,0,16,-49.272727272727266
229,Cluster 12,2015-02,12,0,12,-30.909090909090907
230,Cluster 12,2015-03,25,0,25,-31.25
231,Cluster 12,2015-04,25,0,25,-41.54545454545455
232,Cluster 12,2015-05,15,0,15,-60.90909090909091
233,Cluster 12,2015-06,23,0,23,-54.29545454545455
234,Cluster 12,2015-07,23,0,23,-59.5
235,Cluster 12,2015-08,20,0,20,-58.56818181818181
236,Cluster 12,2015-09,15,0,15,-58.81818181818181
237,Cluster 12,2015-10,15,0,15,-62.227272727272734
238,Cluster 12,2015-11,19,1,18,-52.09090909090909
239,Cluster 12,2015-12,21,2,19,-55.38636363636364
240,Cluster 13,2011-01,11,0,11,-40.22727272727273
241,Cluster 13,2011-02,15,0,15,-33.34090909090909
242,Cluster 13,2011-03,19,0,19,-39.02272727272727
243,Cluster 13,2011-04,30,0,30,-25.113636363636367
244,Cluster 13,2011-05,16,0,16,-48.272727272727266
245,Cluster 13,2011-06,26,1,25,-40.93181818181819
246,Cluster 13,2011-07,28,0,28,-40.522727272727266
247,Cluster 13,2011-08,26,0,26,-41.61363636363636
248,Cluster 13,2011-09,25,0,25,-42.36363636363636
249,Cluster 13,2011-10,19,1,18,-54.93181818181819
250,Cluster 13,2011-11,17,0,17,-51.36363636363636
251,Cluster 13,2011-12,26,0,26,-43.56818181818181
252,Cluster 13,2012-01,9,0,9,-58.45454545454545
253,Cluster 13,2012-02,16,1,15,-38.06818181818182
254,Cluster 13,2012-03,16,0,16,-40.86363636363637
255,Cluster 13,2012-04,12,0,12,-46.20454545454545
256,Cluster 13,2012-05,12,1,11,-54.56818181818181
257,Cluster 13,2012-06,16,1,15,-51.79545454545455
258,Cluster 13,2012-07,16,0,16,-57.18181818181819
259,Cluster 13,2012-08,16,1,15,-61.65909090909091
260,Cluster 13,2012-09,19,1,18,-51.15909090909091
261,Cluster 13,2012-10,16,1,15,-58.61363636363636
262,Cluster 13,2012-11,15,0,15,-50.43181818181819
263,Cluster 13,2012-12,11,0,11,-56.65909090909091
264,Cluster 13,2013-01,14,1,13,-49.72727272727273
265,Cluster 13,2013-02,10,1,9,-40.79545454545455
266,Cluster 13,2013-03,10,0,10,-48.47727272727273
267,Cluster 13,2013-04,9,0,9,-52.45454545454545
268,Cluster 13,2013-05,29,0,29,-43.36363636363636
269,Cluster 13,2013-06,38,1,37,-34.272727272727266
270,Cluster 13,2013-07,17,0,17,-55.31818181818181
271,Cluster 13,2013-08,9,0,9,-65.38636363636364
272,Cluster 13,2013-09,21,1,20,-55.11363636363636
273,Cluster 13,2013-10,23,1,22,-51.45454545454545
274,Cluster 13,2013-11,31,0,31,-35.977272727272734
275,Cluster 13,2013-12,16,0,16,-52.61363636363636
276,Cluster 13,2014-01,10,0,10,-55.022727272727266
277,Cluster 13,2014-02,9,0,9,-40.95454545454545
278,Cluster 13,2014-03,10,0,10,-45.77272727272727
279,Cluster 13,2014-04,35,0,35,-27.159090909090907
280,Cluster 13,2014-05,12,1,11,-59.86363636363636
281,Cluster 13,2014-06,10,0,10,-66.06818181818181
282,Cluster 13,2014-07,13,0,13,-71.1590909090909
283,Cluster 13,2014-08,16,0,16,-71.0
284,Cluster 13,2014-09,9,1,8,-75.11363636363636
285,Cluster 13,2014-10,22,0,22,-65.0909090909091
286,Cluster 13,2014-11,16,0,16,-59.43181818181819
287,Cluster 13,2014-12,3,0,3,-66.5
288,Cluster 13,2015-01,10,0,10,-55.272727272727266
289,Cluster 13,2015-02,6,1,5,-36.90909090909091
290,Cluster 13,2015-03,5,0,5,-51.25
291,Cluster 13,2015-04,11,0,11,-55.54545454545455
292,Cluster 13,2015-05,15,0,15,-60.90909090909091
293,Cluster 13,2015-06,17,1,16,-60.29545454545455
294,Cluster 13,2015-07,25,1,24,-57.5
295,Cluster 13,2015-08,19,0,19,-59.56818181818181
296,Cluster 13,2015-09,11,0,11,-62.81818181818181
297,Cluster 13,2015-10,14,0,14,-63.227272727272734
298,Cluster 13,2015-11,13,0,13,-58.09090909090909
299,Cluster 13,2015-12,22,1,21,-54.38636363636364
300,Cluster 14,2011-01,26,1,25,-25.227272727272727
301,Cluster 14,2011-02,15,1,14,-33.34090909090909
302,Cluster 14,2011-03,19,1,18,-39.02272727272727
303,Cluster 14,2011-04,22,2,20,-33.11363636363637
304,Cluster 14,2011-05,23,0,23,-41.272727272727266
305,Cluster 14,2011-06,29,1,28,-37.93181818181819
306,Cluster 14,2011-07,29,1,28,-39.522727272727266
307,Cluster 14,2011-08,31,1,30,-36.61363636363636
308,Cluster 14,2011-09,29,1,28,-38.36363636363636
309,Cluster 14,2011-10,16,0,16,-57.93181818181819
310,Cluster 14,2011-11,19,1,18,-49.36363636363636
311,Cluster 14,2011-12,18,0,18,-51.56818181818181
312,Cluster 14,2012-01,23,1,22,-44.45454545454545
313,Cluster 14,2012-02,35,0,35,-19.06818181818182
314,Cluster 14,2012-03,21,1,20,-35.86363636363637
315,Cluster 14,2012-04,24,1,23,-34.20454545454545
316,Cluster 14,2012-05,28,0,28,-38.56818181818181
317,Cluster 14,2012-06,38,0,38,-29.795454545454547
318,Cluster 14,2012-07,18,1,17,-55.18181818181819
319,Cluster 14,2012-08,23,2,21,-54.65909090909091
320,Cluster 14,2012-09,23,1,22,-47.15909090909091
321,Cluster 14,2012-10,19,1,18,-55.61363636363636
322,Cluster 14,2012-11,16,0,16,-49.43181818181819
323,Cluster 14,2012-12,21,0,21,-46.65909090909091
324,Cluster 14,2013-01,25,1,24,-38.72727272727273
325,Cluster 14,2013-02,20,0,20,-30.795454545454547
326,Cluster 14,2013-03,20,1,19,-38.47727272727273
327,Cluster 14,2013-04,12,0,12,-49.45454545454545
328,Cluster 14,2013-05,17,1,16,-55.36363636363636
329,Cluster 14,2013-06,18,0,18,-54.272727272727266
330,Cluster 14,2013-07,17,0,17,-55.31818181818181
331,Cluster 14,2013-08,23,0,23,-51.38636363636364
332,Cluster 14,2013-09,22,0,22,-54.11363636363636
333,Cluster 14,2013-10,26,0,26,-48.45454545454545
334,Cluster 14,2013-11,18,0,18,-48.977272727272734
335,Cluster 14,2013-12,25,0,25,-43.61363636363636
336,Cluster 14,2014-01,20,2,18,-45.022727272727266
337,Cluster 14,2014-02,16,3,13,-33.95454545454545
338,Cluster 14,2014-03,15,0,15,-40.77272727272727
339,Cluster 14,2014-04,13,0,13,-49.15909090909091
340,Cluster 14,2014-05,23,1,22,-48.86363636363636
341,Cluster 14,2014-06,30,2,28,-46.06818181818181
342,Cluster 14,2014-07,20,0,20,-64.1590909090909
343,Cluster 14,2014-08,39,2,37,-48.0
344,Cluster 14,2014-09,34,0,34,-50.11363636363636
345,Cluster 14,2014-10,34,0,34,-53.09090909090909
346,Cluster 14,2014-11,28,0,28,-47.43181818181819
347,Cluster 14,2014-12,26,0,26,-43.5
348,Cluster 14,2015-01,28,1,27,-37.272727272727266
349,Cluster 14,2015-02,20,0,20,-22.909090909090907
350,Cluster 14,2015-03,22,0,22,-34.25
351,Cluster 14,2015-04,10,0,10,-56.54545454545455
352,Cluster 14,2015-05,33,2,31,-42.90909090909091
353,Cluster 14,2015-06,42,2,40,-35.29545454545455
354,Cluster 14,2015-07,24,0,24,-58.5
355,Cluster 14,2015-08,35,0,35,-43.56818181818181
356,Cluster 14,2015-09,27,0,27,-46.81818181818181
357,Cluster 14,2015-10,28,0,28,-49.227272727272734
358,Cluster 14,2015-11,29,0,29,-42.09090909090909
359,Cluster 14,2015-12,23,0,23,-53.38636363636364
360,Cluster 15,2011-01,28,1,27,-23.227272727272727
361,Cluster 15,2011-02,24,0,24,-24.340909090909093
362,Cluster 15,2011-03,35,0,35,-23.022727272727273
363,Cluster 15,2011-04,50,1,49,-5.113636363636367
364,Cluster 15,2011-05,50,2,48,-14.272727272727266
365,Cluster 15,2011-06,37,0,37,-29.931818181818187
366,Cluster 15,2011-07,37,0,37,-31.522727272727266
367,Cluster 15,2011-08,29,0,29,-38.61363636363636
368,Cluster 15,2011-09,49,0,49,-18.36363636363636
369,Cluster 15,2011-10,40,0,40,-33.93181818181819
370,Cluster 15,2011-11,39,0,39,-29.36363636363636
371,Cluster 15,2011-12,37,1,36,-32.56818181818181
372,Cluster 15,2012-01,30,0,30,-37.45454545454545
373,Cluster 15,2012-02,38,1,37,-16.06818181818182
374,Cluster 15,2012-03,28,0,28,-28.863636363636367
375,Cluster 15,2012-04,38,0,38,-20.204545454545453
376,Cluster 15,2012-05,45,0,45,-21.568181818181813
377,Cluster 15,2012-06,40,1,39,-27.795454545454547
378,Cluster 15,2012-07,30,1,29,-43.18181818181819
379,Cluster 15,2012-08,46,0,46,-31.659090909090907
380,Cluster 15,2012-09,32,1,31,-38.15909090909091
381,Cluster 15,2012-10,30,0,30,-44.61363636363636
382,Cluster 15,2012-11,19,1,18,-46.43181818181819
383,Cluster 15,2012-12,32,1,31,-35.65909090909091
384,Cluster 15,2013-01,36,0,36,-27.727272727272727
385,Cluster 15,2013-02,24,1,23,-26.795454545454547
386,Cluster 15,2013-03,22,0,22,-36.47727272727273
387,Cluster 15,2013-04,23,1,22,-38.45454545454545
388,Cluster 15,2013-05,21,1,20,-51.36363636363636
389,Cluster 15,2013-06,23,0,23,-49.272727272727266
390,Cluster 15,2013-07,31,0,31,-41.31818181818181
391,Cluster 15,2013-08,20,1,19,-54.38636363636364
392,Cluster 15,2013-09,32,0,32,-44.11363636363636
393,Cluster 15,2013-10,24,1,23,-50.45454545454545
394,Cluster 15,2013-11,39,0,39,-27.977272727272734
395,Cluster 15,2013-12,32,0,32,-36.61363636363636
396,Cluster 15,2014-01,37,0,37,-28.022727272727266
397,Cluster 15,2014-02,26,0,26,-23.954545454545453
398,Cluster 15,2014-03,21,0,21,-34.77272727272727
399,Cluster 15,2014-04,34,2,32,-28.159090909090907
400,Cluster 15,2014-05,26,1,25,-45.86363636363636
401,Cluster 15,2014-06,28,1,27,-48.06818181818181
402,Cluster 15,2014-07,29,2,27,-55.15909090909091
403,Cluster 15,2014-08,21,1,20,-66.0
404,Cluster 15,2014-09,15,0,15,-69.11363636363636
405,Cluster 15,2014-10,39,3,36,-48.09090909090909
406,Cluster 15,2014-11,33,0,33,-42.43181818181819
407,Cluster 15,2014-12,33,0,33,-36.5
408,Cluster 15,2015-01,33,2,31,-32.272727272727266
409,Cluster 15,2015-02,26,0,26,-16.909090909090907
410,Cluster 15,2015-03,22,1,21,-34.25
411,Cluster 15,2015-04,28,1,27,-38.54545454545455
412,Cluster 15,2015-05,32,4,28,-43.90909090909091
413,Cluster 15,2015-06,50,2,48,-27.295454545454547
414,Cluster 15,2015-07,47,1,46,-35.5
415,Cluster 15,2015-08,35,1,34,-43.56818181818181
416,Cluster 15,2015-09,29,0,29,-44.81818181818181
417,Cluster 15,2015-10,33,0,33,-44.227272727272734
418,Cluster 15,2015-11,29,0,29,-42.09090909090909
419,Cluster 15,2015-12,35,0,35,-41.38636363636364
420,Cluster 16,2011-01,11,0,11,-40.22727272727273
421,Cluster 16,2011-02,12,0,12,-36.34090909090909
422,Cluster 16,2011-03,12,1,11,-46.02272727272727
423,Cluster 16,2011-04,7,0,7,-48.11363636363637
424,Cluster 16,2011-05,17,1,16,-47.272727272727266
425,Cluster 16,2011-06,13,1,12,-53.93181818181819
426,Cluster 16,2011-07,12,1,11,-56.522727272727266
427,Cluster 16,2011-08,10,1,9,-57.61363636363636
428,Cluster 16,2011-09,19,1,18,-48.36363636363636
429,Cluster 16,2011-10,31,0,31,-42.93181818181819
430,Cluster 16,2011-11,16,0,16,-52.36363636363636
431,Cluster 16,2011-12,15,0,15,-54.56818181818181
432,Cluster 16,2012-01,25,2,23,-42.45454545454545
433,Cluster 16,2012-02,19,0,19,-35.06818181818182
434,Cluster 16,2012-03,9,2,7,-47.86363636363637
435,Cluster 16,2012-04,14,0,14,-44.20454545454545
436,Cluster 16,2012-05,19,1,18,-47.56818181818181
437,Cluster 16,2012-06,16,1,15,-51.79545454545455
438,Cluster 16,2012-07,24,0,24,-49.18181818181819
439,Cluster 16,2012-08,18,2,16,-59.65909090909091
440,Cluster 16,2012-09,24,1,23,-46.15909090909091
441,Cluster 16,2012-10,10,0,10,-64.61363636363636
442,Cluster 16,2012-11,17,1,16,-48.43181818181819
443,Cluster 16,2012-12,18,0,18,-49.65909090909091
444,Cluster 16,2013-01,20,2,18,-43.72727272727273
445,Cluster 16,2013-02,4,1,3,-46.79545454545455
446,Cluster 16,2013-03,6,0,6,-52.47727272727273
447,Cluster 16,2013-04,11,0,11,-50.45454545454545
448,Cluster 16,2013-05,32,1,31,-40.36363636363636
449,Cluster 16,2013-06,8,0,8,-64.27272727272727
450,Cluster 16,2013-07,4,0,4,-68.31818181818181
451,Cluster 16,2013-08,10,2,8,-64.38636363636364
452,Cluster 16,2013-09,17,2,15,-59.11363636363636
453,Cluster 16,2013-10,11,1,10,-63.45454545454545
454,Cluster 16,2013-11,24,1,23,-42.977272727272734
455,Cluster 16,2013-12,20,0,20,-48.61363636363636
456,Cluster 16,2014-01,21,1,20,-44.022727272727266
457,Cluster 16,2014-02,11,0,11,-38.95454545454545
458,Cluster 16,2014-03,8,0,8,-47.77272727272727
459,Cluster 16,2014-04,7,0,7,-55.15909090909091
460,Cluster 16,2014-05,23,0,23,-48.86363636363636
461,Cluster 16,2014-06,10,0,10,-66.06818181818181
462,Cluster 16,2014-07,14,0,14,-70.1590909090909
463,Cluster 16,2014-08,24,1,23,-63.0
464,Cluster 16,2014-09,37,0,37,-47.11363636363636
465,Cluster 16,2014-10,34,0,34,-53.09090909090909
466,Cluster 16,2014-11,20,1,19,-55.43181818181819
467,Cluster 16,2014-12,21,0,21,-48.5
468,Cluster 16,2015-01,6,0,6,-59.272727272727266
469,Cluster 16,2015-02,9,0,9,-33.90909090909091
470,Cluster 16,2015-03,15,0,15,-41.25
471,Cluster 16,2015-04,17,0,17,-49.54545454545455
472,Cluster 16,2015-05,20,0,20,-55.90909090909091
473,Cluster 16,2015-06,13,0,13,-64.29545454545455
474,Cluster 16,2015-07,18,1,17,-64.5
475,Cluster 16,2015-08,21,0,21,-57.56818181818181
476,Cluster 16,2015-09,21,0,21,-52.81818181818181
477,Cluster 16,2015-10,23,0,23,-54.227272727272734
478,Cluster 16,2015-11,12,0,12,-59.09090909090909
479,Cluster 16,2015-12,11,0,11,-65.38636363636364
480,Cluster 17,2011-01,64,4,60,12.772727272727273
481,Cluster 17,2011-02,58,2,56,9.659090909090907
482,Cluster 17,2011-03,45,6,39,-13.022727272727273
483,Cluster 17,2011-04,56,4,52,0.8863636363636331
484,Cluster 17,2011-05,86,7,79,21.727272727272734
485,Cluster 17,2011-06,82,8,74,15.068181818181813
486,Cluster 17,2011-07,72,3,69,3.4772727272727337
487,Cluster 17,2011-08,87,6,81,19.38636363636364
488,Cluster 17,2011-09,86,2,84,18.63636363636364
489,Cluster 17,2011-10,97,2,95,23.068181818181813
490,Cluster 17,2011-11,58,5,53,-10.36363636363636
491,Cluster 17,2011-12,80,2,78,10.431818181818187
492,Cluster 17,2012-01,73,6,67,5.545454545454547
493,Cluster 17,2012-02,46,4,42,-8.06818181818182
494,Cluster 17,2012-03,55,4,51,-1.8636363636363669
495,Cluster 17,2012-04,58,3,55,-0.20454545454545325
496,Cluster 17,2012-05,69,2,67,2.431818181818187
497,Cluster 17,2012-06,74,3,71,6.204545454545453
498,Cluster 17,2012-07,76,7,69,2.818181818181813
499,Cluster 17,2012-08,75,5,70,-2.6590909090909065
500,Cluster 17,2012-09,66,7,59,-4.1590909090909065
501,Cluster 17,2012-10,102,8,94,27.38636363636364
502,Cluster 17,2012-11,72,8,64,6.568181818181813
503,Cluster 17,2012-12,75,4,71,7.3409090909090935
504,Cluster 17,2013-01,94,3,91,30.272727272727273
505,Cluster 17,2013-02,57,3,54,6.204545454545453
506,Cluster 17,2013-03,59,3,56,0.5227272727272734
507,Cluster 17,2013-04,77,5,72,15.545454545454547
508,Cluster 17,2013-05,81,7,74,8.63636363636364
509,Cluster 17,2013-06,80,4,76,7.727272727272734
510,Cluster 17,2013-07,87,3,84,14.681818181818187
511,Cluster 17,2013-08,87,9,78,12.61363636363636
512,Cluster 17,2013-09,83,6,77,6.88636363636364
513,Cluster 17,2013-10,77,4,73,2.5454545454545467
514,Cluster 17,2013-11,95,3,92,28.022727272727266
515,Cluster 17,2013-12,103,6,97,34.38636363636364
516,Cluster 17,2014-01,108,4,104,42.977272727272734
517,Cluster 17,2014-02,54,4,50,4.045454545454547
518,Cluster 17,2014-03,94,5,89,38.22727272727273
519,Cluster 17,2014-04,78,3,75,15.840909090909093
520,Cluster 17,2014-05,95,4,91,23.13636363636364
521,Cluster 17,2014-06,94,2,92,17.931818181818187
522,Cluster 17,2014-07,120,9,111,35.84090909090909
523,Cluster 17,2014-08,125,5,120,38.0
524,Cluster 17,2014-09,119,4,115,34.88636363636364
525,Cluster 17,2014-10,141,6,135,53.90909090909091
526,Cluster 17,2014-11,127,8,119,51.56818181818181
527,Cluster 17,2014-12,84,2,82,14.5
528,Cluster 17,2015-01,88,4,84,22.727272727272734
529,Cluster 17,2015-02,71,4,67,28.090909090909093
530,Cluster 17,2015-03,83,3,80,26.75
531,Cluster 17,2015-04,98,5,93,31.454545454545453
532,Cluster 17,2015-05,159,3,156,83.0909090909091
533,Cluster 17,2015-06,106,1,105,28.704545454545453
534,Cluster 17,2015-07,118,3,115,35.5
535,Cluster 17,2015-08,99,8,91,20.431818181818187
536,Cluster 17,2015-09,88,5,83,14.181818181818187
537,Cluster 17,2015-10,97,6,91,19.772727272727266
538,Cluster 17,2015-11,110,6,104,38.90909090909091
539,Cluster 17,2015-12,118,2,116,41.61363636363636
540,Cluster 18,2011-01,127,8,119,75.77272727272728
541,Cluster 18,2011-02,82,9,73,33.65909090909091
542,Cluster 18,2011-03,112,5,107,53.97727272727273
543,Cluster 18,2011-04,114,11,103,58.88636363636363
544,Cluster 18,2011-05,143,8,135,78.72727272727273
545,Cluster 18,2011-06,133,16,117,66.06818181818181
546,Cluster 18,2011-07,129,16,113,60.477272727272734
547,Cluster 18,2011-08,167,15,152,99.38636363636364
548,Cluster 18,2011-09,118,11,107,50.63636363636364
549,Cluster 18,2011-10,159,20,139,85.06818181818181
550,Cluster 18,2011-11,122,10,112,53.63636363636364
551,Cluster 18,2011-12,137,10,127,67.43181818181819
552,Cluster 18,2012-01,115,9,106,47.54545454545455
553,Cluster 18,2012-02,115,7,108,60.93181818181818
554,Cluster 18,2012-03,111,11,100,54.13636363636363
555,Cluster 18,2012-04,111,18,93,52.79545454545455
556,Cluster 18,2012-05,101,10,91,34.43181818181819
557,Cluster 18,2012-06,149,16,133,81.20454545454545
558,Cluster 18,2012-07,144,11,133,70.81818181818181
559,Cluster 18,2012-08,166,24,142,88.3409090909091
560,Cluster 18,2012-09,159,14,145,88.8409090909091
561,Cluster 18,2012-10,168,7,161,93.38636363636364
562,Cluster 18,2012-11,139,11,128,73.56818181818181
563,Cluster 18,2012-12,136,10,126,68.3409090909091
564,Cluster 18,2013-01,128,10,118,64.27272727272728
565,Cluster 18,2013-02,91,9,82,40.20454545454545
566,Cluster 18,2013-03,90,8,82,31.522727272727273
567,Cluster 18,2013-04,124,14,110,62.54545454545455
568,Cluster 18,2013-05,151,19,132,78.63636363636364
569,Cluster 18,2013-06,163,20,143,90.72727272727273
570,Cluster 18,2013-07,131,12,119,58.68181818181819
571,Cluster 18,2013-08,195,14,181,120.61363636363636
572,Cluster 18,2013-09,195,16,179,118.88636363636364
573,Cluster 18,2013-10,180,12,168,105.54545454545455
574,Cluster 18,2013-11,171,7,164,104.02272727272727
575,Cluster 18,2013-12,141,7,134,72.38636363636364
576,Cluster 18,2014-01,157,15,142,91.97727272727273
577,Cluster 18,2014-02,101,8,93,51.04545454545455
578,Cluster 18,2014-03,128,12,116,72.22727272727272
579,Cluster 18,2014-04,142,14,128,79.8409090909091
580,Cluster 18,2014-05,133,7,126,61.13636363636364
581,Cluster 18,2014-06,206,22,184,129.9318181818182
582,Cluster 18,2014-07,156,16,140,71.8409090909091
583,Cluster 18,2014-08,179,10,169,92.0
584,Cluster 18,2014-09,187,13,174,102.88636363636364
585,Cluster 18,2014-10,194,17,177,106.9090909090909
586,Cluster 18,2014-11,174,10,164,98.56818181818181
587,Cluster 18,2014-12,133,15,118,63.5
588,Cluster 18,2015-01,122,9,113,56.727272727272734
589,Cluster 18,2015-02,88,6,82,45.09090909090909
590,Cluster 18,2015-03,106,10,96,49.75
591,Cluster 18,2015-04,181,20,161,114.45454545454545
592,Cluster 18,2015-05,177,21,156,101.0909090909091
593,Cluster 18,2015-06,175,9,166,97.70454545454545
594,Cluster 18,2015-07,172,9,163,89.5
595,Cluster 18,2015-08,157,12,145,78.43181818181819
596,Cluster 18,2015-09,159,12,147,85.18181818181819
597,Cluster 18,2015-10,101,5,96,23.772727272727266
598,Cluster 18,2015-11,127,7,120,55.90909090909091
599,Cluster 18,2015-12,141,10,131,64.61363636363636
600,Cluster 19,2011-01,28,3,25,-23.227272727272727
601,Cluster 19,2011-02,32,1,31,-16.340909090909093
602,Cluster 19,2011-03,30,3,27,-28.022727272727273
603,Cluster 19,2011-04,32,3,29,-23.113636363636367
604,Cluster 19,2011-05,43,4,39,-21.272727272727266
605,Cluster 19,2011-06,33,5,28,-33.93181818181819
606,Cluster 19,2011-07,33,3,30,-35.522727272727266
607,Cluster 19,2011-08,26,3,23,-41.61363636363636
608,Cluster 19,2011-09,29,1,28,-38.36363636363636
609,Cluster 19,2011-10,37,4,33,-36.93181818181819
610,Cluster 19,2011-11,38,0,38,-30.36363636363636
611,Cluster 19,2011-12,36,5,31,-33.56818181818181
612,Cluster 19,2012-01,50,2,48,-17.454545454545453
613,Cluster 19,2012-02,19,1,18,-35.06818181818182
614,Cluster 19,2012-03,32,5,27,-24.863636363636367
615,Cluster 19,2012-04,30,5,25,-28.204545454545453
616,Cluster 19,2012-05,32,1,31,-34.56818181818181
617,Cluster 19,2012-06,41,6,35,-26.795454545454547
618,Cluster 19,2012-07,33,7,26,-40.18181818181819
619,Cluster 19,2012-08,40,3,37,-37.65909090909091
620,Cluster 19,2012-09,36,3,33,-34.15909090909091
621,Cluster 19,2012-10,22,1,21,-52.61363636363636
622,Cluster 19,2012-11,32,3,29,-33.43181818181819
623,Cluster 19,2012-12,34,3,31,-33.65909090909091
624,Cluster 19,2013-01,24,2,22,-39.72727272727273
625,Cluster 19,2013-02,32,5,27,-18.795454545454547
626,Cluster 19,2013-03,13,0,13,-45.47727272727273
627,Cluster 19,2013-04,22,2,20,-39.45454545454545
628,Cluster 19,2013-05,34,3,31,-38.36363636363636
629,Cluster 19,2013-06,25,4,21,-47.272727272727266
630,Cluster 19,2013-07,43,6,37,-29.318181818181813
631,Cluster 19,2013-08,39,4,35,-35.38636363636364
632,Cluster 19,2013-09,36,2,34,-40.11363636363636
633,Cluster 19,2013-10,31,2,29,-43.45454545454545
634,Cluster 19,2013-11,39,4,35,-27.977272727272734
635,Cluster 19,2013-12,39,2,37,-29.61363636363636
636,Cluster 19,2014-01,39,2,37,-26.022727272727266
637,Cluster 19,2014-02,28,1,27,-21.954545454545453
638,Cluster 19,2014-03,25,4,21,-30.772727272727273
639,Cluster 19,2014-04,26,3,23,-36.15909090909091
640,Cluster 19,2014-05,38,1,37,-33.86363636363636
641,Cluster 19,2014-06,41,4,37,-35.06818181818181
642,Cluster 19,2014-07,53,6,47,-31.159090909090907
643,Cluster 19,2014-08,52,6,46,-35.0
644,Cluster 19,2014-09,50,3,47,-34.11363636363636
645,Cluster 19,2014-10,54,8,46,-33.09090909090909
646,Cluster 19,2014-11,45,0,45,-30.431818181818187
647,Cluster 19,2014-12,57,4,53,-12.5
648,Cluster 19,2015-01,36,3,33,-29.272727272727266
649,Cluster 19,2015-02,26,2,24,-16.909090909090907
650,Cluster 19,2015-03,34,4,30,-22.25
651,Cluster 19,2015-04,49,4,45,-17.545454545454547
652,Cluster 19,2015-05,63,7,56,-12.909090909090907
653,Cluster 19,2015-06,38,4,34,-39.29545454545455
654,Cluster 19,2015-07,55,5,50,-27.5
655,Cluster 19,2015-08,47,3,44,-31.568181818181813
656,Cluster 19,2015-09,53,4,49,-20.818181818181813
657,Cluster 19,2015-10,33,4,29,-44.227272727272734
658,Cluster 19,2015-11,36,4,32,-35.09090909090909
659,Cluster 19,2015-12,43,5,38,-33.38636363636364
660,Cluster 2,2011-01,148,9,139,96.77272727272728
661,Cluster 2,2011-02,199,12,187,150.6590909090909
662,Cluster 2,2011-03,223,13,210,164.97727272727272
663,Cluster 2,2011-04,193,14,179,137.88636363636363
664,Cluster 2,2011-05,218,20,198,153.72727272727275
665,Cluster 2,2011-06,235,13,222,168.0681818181818
666,Cluster 2,2011-07,245,18,227,176.47727272727275
667,Cluster 2,2011-08,258,16,242,190.38636363636363
668,Cluster 2,2011-09,247,11,236,179.63636363636363
669,Cluster 2,2011-10,284,10,274,210.0681818181818
670,Cluster 2,2011-11,292,8,284,223.63636363636363
671,Cluster 2,2011-12,251,11,240,181.4318181818182
672,Cluster 2,2012-01,240,15,225,172.54545454545456
673,Cluster 2,2012-02,175,8,167,120.93181818181819
674,Cluster 2,2012-03,186,9,177,129.13636363636363
675,Cluster 2,2012-04,195,14,181,136.79545454545456
676,Cluster 2,2012-05,237,13,224,170.4318181818182
677,Cluster 2,2012-06,251,16,235,183.20454545454544
678,Cluster 2,2012-07,268,14,254,194.8181818181818
679,Cluster 2,2012-08,234,12,222,156.3409090909091
680,Cluster 2,2012-09,230,10,220,159.8409090909091
681,Cluster 2,2012-10,291,17,274,216.38636363636363
682,Cluster 2,2012-11,227,8,219,161.5681818181818
683,Cluster 2,2012-12,240,7,233,172.3409090909091
684,Cluster 2,2013-01,192,11,181,128.27272727272728
685,Cluster 2,2013-02,191,9,182,140.20454545454544
686,Cluster 2,2013-03,250,16,234,191.52272727272728
687,Cluster 2,2013-04,221,11,210,159.54545454545456
688,Cluster 2,2013-05,281,13,268,208.63636363636363
689,Cluster 2,2013-06,325,16,309,252.72727272727275
690,Cluster 2,2013-07,267,13,254,194.6818181818182
691,Cluster 2,2013-08,274,12,262,199.61363636363637
692,Cluster 2,2013-09,320,16,304,243.88636363636363
693,Cluster 2,2013-10,311,12,299,236.54545454545456
694,Cluster 2,2013-11,272,13,259,205.02272727272725
695,Cluster 2,2013-12,268,14,254,199.38636363636363
696,Cluster 2,2014-01,219,13,206,153.97727272727275
697,Cluster 2,2014-02,178,11,167,128.04545454545456
698,Cluster 2,2014-03,194,8,186,138.22727272727272
699,Cluster 2,2014-04,222,16,206,159.8409090909091
700,Cluster 2,2014-05,263,15,248,191.13636363636363
701,Cluster 2,2014-06,263,17,246,186.9318181818182
702,Cluster 2,2014-07,346,21,325,261.8409090909091
703,Cluster 2,2014-08,336,21,315,249.0
704,Cluster 2,2014-09,303,14,289,218.88636363636363
705,Cluster 2,2014-10,293,15,278,205.9090909090909
706,Cluster 2,2014-11,288,5,283,212.5681818181818
707,Cluster 2,2014-12,250,9,241,180.5
708,Cluster 2,2015-01,227,12,215,161.72727272727275
709,Cluster 2,2015-02,166,12,154,123.0909090909091
710,Cluster 2,2015-03,236,14,222,179.75
711,Cluster 2,2015-04,244,15,229,177.45454545454544
712,Cluster 2,2015-05,315,10,305,239.0909090909091
713,Cluster 2,2015-06,354,13,341,276.70454545454544
714,Cluster 2,2015-07,315,15,300,232.5
715,Cluster 2,2015-08,309,21,288,230.4318181818182
716,Cluster 2,2015-09,293,9,284,219.1818181818182
717,Cluster 2,2015-10,246,13,233,168.77272727272725
718,Cluster 2,2015-11,250,14,236,178.9090909090909
719,Cluster 2,2015-12,227,12,215,150.61363636363637
720,Cluster 20,2011-01,25,0,25,-26.227272727272727
721,Cluster 20,2011-02,33,0,33,-15.340909090909093
722,Cluster 20,2011-03,32,0,32,-26.022727272727273
723,Cluster 20,2011-04,28,3,25,-27.113636363636367
724,Cluster 20,2011-05,31,2,29,-33.272727272727266
725,Cluster 20,2011-06,36,3,33,-30.931818181818187
726,Cluster 20,2011-07,34,1,33,-34.522727272727266
727,Cluster 20,2011-08,37,1,36,-30.61363636363636
728,Cluster 20,2011-09,28,1,27,-39.36363636363636
729,Cluster 20,2011-10,50,2,48,-23.931818181818187
730,Cluster 20,2011-11,35,1,34,-33.36363636363636
731,Cluster 20,2011-12,34,2,32,-35.56818181818181
732,Cluster 20,2012-01,60,5,55,-7.454545454545453
733,Cluster 20,2012-02,35,3,32,-19.06818181818182
734,Cluster 20,2012-03,26,0,26,-30.863636363636367
735,Cluster 20,2012-04,25,3,22,-33.20454545454545
736,Cluster 20,2012-05,43,3,40,-23.568181818181813
737,Cluster 20,2012-06,40,1,39,-27.795454545454547
738,Cluster 20,2012-07,39,2,37,-34.18181818181819
739,Cluster 20,2012-08,53,4,49,-24.659090909090907
740,Cluster 20,2012-09,35,2,33,-35.15909090909091
741,Cluster 20,2012-10,42,2,40,-32.61363636363636
742,Cluster 20,2012-11,37,1,36,-28.431818181818187
743,Cluster 20,2012-12,29,4,25,-38.65909090909091
744,Cluster 20,2013-01,42,0,42,-21.727272727272727
745,Cluster 20,2013-02,34,1,33,-16.795454545454547
746,Cluster 20,2013-03,22,2,20,-36.47727272727273
747,Cluster 20,2013-04,34,1,33,-27.454545454545453
748,Cluster 20,2013-05,37,2,35,-35.36363636363636
749,Cluster 20,2013-06,27,2,25,-45.272727272727266
750,Cluster 20,2013-07,41,0,41,-31.318181818181813
751,Cluster 20,2013-08,37,4,33,-37.38636363636364
752,Cluster 20,2013-09,31,2,29,-45.11363636363636
753,Cluster 20,2013-10,34,4,30,-40.45454545454545
754,Cluster 20,2013-11,30,1,29,-36.977272727272734
755,Cluster 20,2013-12,27,6,21,-41.61363636363636
756,Cluster 20,2014-01,40,3,37,-25.022727272727266
757,Cluster 20,2014-02,29,0,29,-20.954545454545453
758,Cluster 20,2014-03,33,2,31,-22.772727272727273
759,Cluster 20,2014-04,34,3,31,-28.159090909090907
760,Cluster 20,2014-05,67,3,64,-4.86363636363636
761,Cluster 20,2014-06,46,2,44,-30.068181818181813
762,Cluster 20,2014-07,40,1,39,-44.15909090909091
763,Cluster 20,2014-08,54,0,54,-33.0
764,Cluster 20,2014-09,56,1,55,-28.11363636363636
765,Cluster 20,2014-10,56,2,54,-31.090909090909093
766,Cluster 20,2014-11,49,4,45,-26.431818181818187
767,Cluster 20,2014-12,35,1,34,-34.5
768,Cluster 20,2015-01,39,2,37,-26.272727272727266
769,Cluster 20,2015-02,18,2,16,-24.909090909090907
770,Cluster 20,2015-03,38,0,38,-18.25
771,Cluster 20,2015-04,57,5,52,-9.545454545454547
772,Cluster 20,2015-05,34,4,30,-41.90909090909091
773,Cluster 20,2015-06,36,2,34,-41.29545454545455
774,Cluster 20,2015-07,42,1,41,-40.5
775,Cluster 20,2015-08,47,4,43,-31.568181818181813
776,Cluster 20,2015-09,32,3,29,-41.81818181818181
777,Cluster 20,2015-10,38,2,36,-39.227272727272734
778,Cluster 20,2015-11,43,2,41,-28.090909090909093
779,Cluster 20,2015-12,45,3,42,-31.38636363636364
780,Cluster 21,2011-01,84,7,77,32.77272727272727
781,Cluster 21,2011-02,72,4,68,23.659090909090907
782,Cluster 21,2011-03,100,12,88,41.97727272727273
783,Cluster 21,2011-04,90,12,78,34.88636363636363
784,Cluster 21,2011-05,83,5,78,18.727272727272734
785,Cluster 21,2011-06,118,7,111,51.06818181818181
786,Cluster 21,2011-07,122,13,109,53.477272727272734
787,Cluster 21,2011-08,97,12,85,29.38636363636364
788,Cluster 21,2011-09,113,7,106,45.63636363636364
789,Cluster 21,2011-10,127,14,113,53.06818181818181
790,Cluster 21,2011-11,107,8,99,38.63636363636364
791,Cluster 21,2011-12,115,8,107,45.43181818181819
792,Cluster 21,2012-01,135,9,126,67.54545454545455
793,Cluster 21,2012-02,84,7,77,29.93181818181818
794,Cluster 21,2012-03,95,10,85,38.13636363636363
795,Cluster 21,2012-04,110,14,96,51.79545454545455
796,Cluster 21,2012-05,107,7,100,40.43181818181819
797,Cluster 21,2012-06,107,11,96,39.20454545454545
798,Cluster 21,2012-07,150,6,144,76.81818181818181
799,Cluster 21,2012-08,155,14,141,77.3409090909091
800,Cluster 21,2012-09,137,4,133,66.8409090909091
801,Cluster 21,2012-10,130,11,119,55.38636363636364
802,Cluster 21,2012-11,117,8,109,51.56818181818181
803,Cluster 21,2012-12,89,5,84,21.340909090909093
804,Cluster 21,2013-01,103,9,94,39.27272727272727
805,Cluster 21,2013-02,84,3,81,33.20454545454545
806,Cluster 21,2013-03,86,8,78,27.522727272727273
807,Cluster 21,2013-04,97,6,91,35.54545454545455
808,Cluster 21,2013-05,105,3,102,32.63636363636364
809,Cluster 21,2013-06,89,11,78,16.727272727272734
810,Cluster 21,2013-07,106,11,95,33.68181818181819
811,Cluster 21,2013-08,113,13,100,38.61363636363636
812,Cluster 21,2013-09,105,6,99,28.88636363636364
813,Cluster 21,2013-10,101,9,92,26.545454545454547
814,Cluster 21,2013-11,76,9,67,9.022727272727266
815,Cluster 21,2013-12,99,6,93,30.38636363636364
816,Cluster 21,2014-01,110,9,101,44.977272727272734
817,Cluster 21,2014-02,66,3,63,16.045454545454547
818,Cluster 21,2014-03,75,7,68,19.227272727272727
819,Cluster 21,2014-04,100,11,89,37.84090909090909
820,Cluster 21,2014-05,127,13,114,55.13636363636364
821,Cluster 21,2014-06,135,9,126,58.93181818181819
822,Cluster 21,2014-07,117,12,105,32.84090909090909
823,Cluster 21,2014-08,152,7,145,65.0
824,Cluster 21,2014-09,154,9,145,69.88636363636364
825,Cluster 21,2014-10,166,9,157,78.9090909090909
826,Cluster 21,2014-11,144,7,137,68.56818181818181
827,Cluster 21,2014-12,116,7,109,46.5
828,Cluster 21,2015-01,111,4,107,45.727272727272734
829,Cluster 21,2015-02,69,7,62,26.090909090909093
830,Cluster 21,2015-03,86,7,79,29.75
831,Cluster 21,2015-04,122,6,116,55.45454545454545
832,Cluster 21,2015-05,138,17,121,62.09090909090909
833,Cluster 21,2015-06,138,13,125,60.70454545454545
834,Cluster 21,2015-07,134,12,122,51.5
835,Cluster 21,2015-08,134,12,122,55.43181818181819
836,Cluster 21,2015-09,114,4,110,40.18181818181819
837,Cluster 21,2015-10,124,5,119,46.772727272727266
838,Cluster 21,2015-11,87,10,77,15.909090909090907
839,Cluster 21,2015-12,121,9,112,44.61363636363636
840,Cluster 22,2011-01,57,2,55,5.772727272727273
841,Cluster 22,2011-02,85,7,78,36.65909090909091
842,Cluster 22,2011-03,82,9,73,23.977272727272727
843,Cluster 22,2011-04,78,9,69,22.886363636363633
844,Cluster 22,2011-05,87,6,81,22.727272727272734
845,Cluster 22,2011-06,92,5,87,25.068181818181813
846,Cluster 22,2011-07,99,12,87,30.477272727272734
847,Cluster 22,2011-08,90,10,80,22.38636363636364
848,Cluster 22,2011-09,81,11,70,13.63636363636364
849,Cluster 22,2011-10,107,10,97,33.06818181818181
850,Cluster 22,2011-11,91,3,88,22.63636363636364
851,Cluster 22,2011-12,86,12,74,16.431818181818187
852,Cluster 22,2012-01,77,7,70,9.545454545454547
853,Cluster 22,2012-02,81,9,72,26.93181818181818
854,Cluster 22,2012-03,83,7,76,26.136363636363633
855,Cluster 22,2012-04,95,13,82,36.79545454545455
856,Cluster 22,2012-05,109,6,103,42.43181818181819
857,Cluster 22,2012-06,83,11,72,15.204545454545453
858,Cluster 22,2012-07,102,7,95,28.818181818181813
859,Cluster 22,2012-08,102,9,93,24.340909090909093
860,Cluster 22,2012-09,93,12,81,22.840909090909093
861,Cluster 22,2012-10,87,7,80,12.38636363636364
862,Cluster 22,2012-11,89,3,86,23.568181818181813
863,Cluster 22,2012-12,87,7,80,19.340909090909093
864,Cluster 22,2013-01,101,5,96,37.27272727272727
865,Cluster 22,2013-02,57,5,52,6.204545454545453
866,Cluster 22,2013-03,78,3,75,19.522727272727273
867,Cluster 22,2013-04,68,8,60,6.545454545454547
868,Cluster 22,2013-05,116,6,110,43.63636363636364
869,Cluster 22,2013-06,112,12,100,39.727272727272734
870,Cluster 22,2013-07,129,10,119,56.68181818181819
871,Cluster 22,2013-08,134,6,128,59.61363636363636
872,Cluster 22,2013-09,105,3,102,28.88636363636364
873,Cluster 22,2013-10,95,4,91,20.545454545454547
874,Cluster 22,2013-11,107,5,102,40.022727272727266
875,Cluster 22,2013-12,95,6,89,26.38636363636364
876,Cluster 22,2014-01,107,8,99,41.977272727272734
877,Cluster 22,2014-02,73,7,66,23.045454545454547
878,Cluster 22,2014-03,79,5,74,23.227272727272727
879,Cluster 22,2014-04,99,6,93,36.84090909090909
880,Cluster 22,2014-05,111,5,106,39.13636363636364
881,Cluster 22,2014-06,99,1,98,22.931818181818187
882,Cluster 22,2014-07,124,2,122,39.84090909090909
883,Cluster 22,2014-08,158,11,147,71.0
884,Cluster 22,2014-09,150,12,138,65.88636363636364
885,Cluster 22,2014-10,144,7,137,56.90909090909091
886,Cluster 22,2014-11,89,3,86,13.568181818181813
887,Cluster 22,2014-12,119,6,113,49.5
888,Cluster 22,2015-01,94,2,92,28.727272727272734
889,Cluster 22,2015-02,75,3,72,32.09090909090909
890,Cluster 22,2015-03,123,2,121,66.75
891,Cluster 22,2015-04,112,5,107,45.45454545454545
892,Cluster 22,2015-05,133,9,124,57.09090909090909
893,Cluster 22,2015-06,106,6,100,28.704545454545453
894,Cluster 22,2015-07,131,17,114,48.5
895,Cluster 22,2015-08,117,11,106,38.43181818181819
896,Cluster 22,2015-09,113,10,103,39.18181818181819
897,Cluster 22,2015-10,158,9,149,80.77272727272727
898,Cluster 22,2015-11,102,5,97,30.909090909090907
899,Cluster 22,2015-12,120,5,115,43.61363636363636
900,Cluster 23,2011-01,86,13,73,34.77272727272727
901,Cluster 23,2011-02,69,13,56,20.659090909090907
902,Cluster 23,2011-03,92,15,77,33.97727272727273
903,Cluster 23,2011-04,75,6,69,19.886363636363633
904,Cluster 23,2011-05,109,18,91,44.727272727272734
905,Cluster 23,2011-06,114,13,101,47.06818181818181
906,Cluster 23,2011-07,91,13,78,22.477272727272734
907,Cluster 23,2011-08,89,13,76,21.38636363636364
908,Cluster 23,2011-09,129,19,110,61.63636363636364
909,Cluster 23,2011-10,118,13,105,44.06818181818181
910,Cluster 23,2011-11,84,10,74,15.63636363636364
911,Cluster 23,2011-12,101,12,89,31.431818181818187
912,Cluster 23,2012-01,102,13,89,34.54545454545455
913,Cluster 23,2012-02,73,9,64,18.93181818181818
914,Cluster 23,2012-03,79,12,67,22.136363636363633
915,Cluster 23,2012-04,78,17,61,19.795454545454547
916,Cluster 23,2012-05,104,10,94,37.43181818181819
917,Cluster 23,2012-06,131,19,112,63.20454545454545
918,Cluster 23,2012-07,138,22,116,64.81818181818181
919,Cluster 23,2012-08,141,18,123,63.34090909090909
920,Cluster 23,2012-09,124,22,102,53.84090909090909
921,Cluster 23,2012-10,118,14,104,43.38636363636364
922,Cluster 23,2012-11,99,12,87,33.56818181818181
923,Cluster 23,2012-12,118,14,104,50.34090909090909
924,Cluster 23,2013-01,103,14,89,39.27272727272727
925,Cluster 23,2013-02,91,14,77,40.20454545454545
926,Cluster 23,2013-03,108,10,98,49.52272727272727
927,Cluster 23,2013-04,108,11,97,46.54545454545455
928,Cluster 23,2013-05,119,18,101,46.63636363636364
929,Cluster 23,2013-06,117,22,95,44.727272727272734
930,Cluster 23,2013-07,115,13,102,42.68181818181819
931,Cluster 23,2013-08,111,11,100,36.61363636363636
932,Cluster 23,2013-09,127,14,113,50.88636363636364
933,Cluster 23,2013-10,121,12,109,46.54545454545455
934,Cluster 23,2013-11,94,8,86,27.022727272727266
935,Cluster 23,2013-12,111,7,104,42.38636363636364
936,Cluster 23,2014-01,87,7,80,21.977272727272734
937,Cluster 23,2014-02,79,8,71,29.045454545454547
938,Cluster 23,2014-03,101,17,84,45.22727272727273
939,Cluster 23,2014-04,105,18,87,42.84090909090909
940,Cluster 23,2014-05,125,13,112,53.13636363636364
941,Cluster 23,2014-06,118,15,103,41.93181818181819
942,Cluster 23,2014-07,152,19,133,67.8409090909091
943,Cluster 23,2014-08,144,17,127,57.0
944,Cluster 23,2014-09,157,13,144,72.88636363636364
945,Cluster 23,2014-10,138,20,118,50.90909090909091
946,Cluster 23,2014-11,115,26,89,39.56818181818181
947,Cluster 23,2014-12,106,13,93,36.5
948,Cluster 23,2015-01,137,12,125,71.72727272727273
949,Cluster 23,2015-02,66,11,55,23.090909090909093
950,Cluster 23,2015-03,108,23,85,51.75
951,Cluster 23,2015-04,111,26,85,44.45454545454545
952,Cluster 23,2015-05,126,15,111,50.09090909090909
953,Cluster 23,2015-06,124,15,109,46.70454545454545
954,Cluster 23,2015-07,146,19,127,63.5
955,Cluster 23,2015-08,109,19,90,30.431818181818187
956,Cluster 23,2015-09,135,19,116,61.18181818181819
957,Cluster 23,2015-10,108,15,93,30.772727272727266
958,Cluster 23,2015-11,110,13,97,38.90909090909091
959,Cluster 23,2015-12,123,16,107,46.61363636363636
960,Cluster 24,2011-01,24,0,24,-27.227272727272727
961,Cluster 24,2011-02,37,2,35,-11.340909090909093
962,Cluster 24,2011-03,34,2,32,-24.022727272727273
963,Cluster 24,2011-04,26,2,24,-29.113636363636367
964,Cluster 24,2011-05,37,2,35,-27.272727272727266
965,Cluster 24,2011-06,34,2,32,-32.93181818181819
966,Cluster 24,2011-07,39,6,33,-29.522727272727266
967,Cluster 24,2011-08,29,0,29,-38.61363636363636
968,Cluster 24,2011-09,31,0,31,-36.36363636363636
969,Cluster 24,2011-10,41,1,40,-32.93181818181819
970,Cluster 24,2011-11,33,2,31,-35.36363636363636
971,Cluster 24,2011-12,29,1,28,-40.56818181818181
972,Cluster 24,2012-01,26,2,24,-41.45454545454545
973,Cluster 24,2012-02,32,0,32,-22.06818181818182
974,Cluster 24,2012-03,27,1,26,-29.863636363636367
975,Cluster 24,2012-04,31,2,29,-27.204545454545453
976,Cluster 24,2012-05,43,4,39,-23.568181818181813
977,Cluster 24,2012-06,33,4,29,-34.79545454545455
978,Cluster 24,2012-07,39,4,35,-34.18181818181819
979,Cluster 24,2012-08,50,3,47,-27.659090909090907
980,Cluster 24,2012-09,41,3,38,-29.159090909090907
981,Cluster 24,2012-10,43,4,39,-31.61363636363636
982,Cluster 24,2012-11,27,1,26,-38.43181818181819
983,Cluster 24,2012-12,38,3,35,-29.659090909090907
984,Cluster 24,2013-01,30,3,27,-33.72727272727273
985,Cluster 24,2013-02,43,3,40,-7.795454545454547
986,Cluster 24,2013-03,27,1,26,-31.477272727272727
987,Cluster 24,2013-04,30,1,29,-31.454545454545453
988,Cluster 24,2013-05,46,1,45,-26.36363636363636
989,Cluster 24,2013-06,40,3,37,-32.272727272727266
990,Cluster 24,2013-07,45,4,41,-27.318181818181813
991,Cluster 24,2013-08,46,7,39,-28.38636363636364
992,Cluster 24,2013-09,42,2,40,-34.11363636363636
993,Cluster 24,2013-10,47,1,46,-27.454545454545453
994,Cluster 24,2013-11,30,2,28,-36.977272727272734
995,Cluster 24,2013-12,41,0,41,-27.61363636363636
996,Cluster 24,2014-01,42,3,39,-23.022727272727266
997,Cluster 24,2014-02,25,1,24,-24.954545454545453
998,Cluster 24,2014-03,26,1,25,-29.772727272727273
999,Cluster 24,2014-04,33,1,32,-29.159090909090907
1000,Cluster 24,2014-05,47,5,42,-24.86363636363636
1001,Cluster 24,2014-06,42,0,42,-34.06818181818181
1002,Cluster 24,2014-07,44,4,40,-40.15909090909091
1003,Cluster 24,2014-08,56,1,55,-31.0
1004,Cluster 24,2014-09,48,3,45,-36.11363636363636
1005,Cluster 24,2014-10,46,2,44,-41.09090909090909
1006,Cluster 24,2014-11,45,1,44,-30.431818181818187
1007,Cluster 24,2014-12,37,1,36,-32.5
1008,Cluster 24,2015-01,36,0,36,-29.272727272727266
1009,Cluster 24,2015-02,26,2,24,-16.909090909090907
1010,Cluster 24,2015-03,37,2,35,-19.25
1011,Cluster 24,2015-04,47,1,46,-19.545454545454547
1012,Cluster 24,2015-05,45,2,43,-30.909090909090907
1013,Cluster 24,2015-06,44,0,44,-33.29545454545455
1014,Cluster 24,2015-07,56,3,53,-26.5
1015,Cluster 24,2015-08,37,0,37,-41.56818181818181
1016,Cluster 24,2015-09,24,1,23,-49.81818181818181
1017,Cluster 24,2015-10,45,2,43,-32.227272727272734
1018,Cluster 24,2015-11,37,4,33,-34.09090909090909
1019,Cluster 24,2015-12,55,5,50,-21.38636363636364
1020,Cluster 25,2011-01,104,8,96,52.77272727272727
1021,Cluster 25,2011-02,76,6,70,27.659090909090907
1022,Cluster 25,2011-03,121,6,115,62.97727272727273
1023,Cluster 25,2011-04,108,5,103,52.88636363636363
1024,Cluster 25,2011-05,161,11,150,96.72727272727273
1025,Cluster 25,2011-06,180,7,173,113.06818181818181
1026,Cluster 25,2011-07,181,6,175,112.47727272727273
1027,Cluster 25,2011-08,161,8,153,93.38636363636364
1028,Cluster 25,2011-09,184,10,174,116.63636363636364
1029,Cluster 25,2011-10,184,13,171,110.06818181818181
1030,Cluster 25,2011-11,172,7,165,103.63636363636364
1031,Cluster 25,2011-12,177,6,171,107.43181818181819
1032,Cluster 25,2012-01,223,12,211,155.54545454545456
1033,Cluster 25,2012-02,157,7,150,102.93181818181819
1034,Cluster 25,2012-03,140,7,133,83.13636363636363
1035,Cluster 25,2012-04,154,9,145,95.79545454545455
1036,Cluster 25,2012-05,163,14,149,96.43181818181819
1037,Cluster 25,2012-06,162,9,153,94.20454545454545
1038,Cluster 25,2012-07,185,11,174,111.81818181818181
1039,Cluster 25,2012-08,205,8,197,127.3409090909091
1040,Cluster 25,2012-09,233,10,223,162.8409090909091
1041,Cluster 25,2012-10,182,7,175,107.38636363636364
1042,Cluster 25,2012-11,154,9,145,88.56818181818181
1043,Cluster 25,2012-12,172,8,164,104.3409090909091
1044,Cluster 25,2013-01,178,4,174,114.27272727272728
1045,Cluster 25,2013-02,166,4,162,115.20454545454545
1046,Cluster 25,2013-03,146,14,132,87.52272727272728
1047,Cluster 25,2013-04,152,10,142,90.54545454545455
1048,Cluster 25,2013-05,191,10,181,118.63636363636364
1049,Cluster 25,2013-06,181,11,170,108.72727272727273
1050,Cluster 25,2013-07,219,12,207,146.6818181818182
1051,Cluster 25,2013-08,213,8,205,138.61363636363637
1052,Cluster 25,2013-09,189,9,180,112.88636363636364
1053,Cluster 25,2013-10,204,9,195,129.54545454545456
1054,Cluster 25,2013-11,123,4,119,56.022727272727266
1055,Cluster 25,2013-12,148,7,141,79.38636363636364
1056,Cluster 25,2014-01,168,10,158,102.97727272727273
1057,Cluster 25,2014-02,104,3,101,54.04545454545455
1058,Cluster 25,2014-03,115,5,110,59.22727272727273
1059,Cluster 25,2014-04,132,8,124,69.8409090909091
1060,Cluster 25,2014-05,172,8,164,100.13636363636364
1061,Cluster 25,2014-06,215,11,204,138.9318181818182
1062,Cluster 25,2014-07,247,18,229,162.8409090909091
1063,Cluster 25,2014-08,222,10,212,135.0
1064,Cluster 25,2014-09,233,14,219,148.88636363636363
1065,Cluster 25,2014-10,257,8,249,169.9090909090909
1066,Cluster 25,2014-11,189,8,181,113.56818181818181
1067,Cluster 25,2014-12,166,6,160,96.5
1068,Cluster 25,2015-01,174,7,167,108.72727272727273
1069,Cluster 25,2015-02,123,6,117,80.0909090909091
1070,Cluster 25,2015-03,136,12,124,79.75
1071,Cluster 25,2015-04,176,8,168,109.45454545454545
1072,Cluster 25,2015-05,171,8,163,95.0909090909091
1073,Cluster 25,2015-06,204,9,195,126.70454545454545
1074,Cluster 25,2015-07,206,16,190,123.5
1075,Cluster 25,2015-08,221,16,205,142.4318181818182
1076,Cluster 25,2015-09,168,12,156,94.18181818181819
1077,Cluster 25,2015-10,219,7,212,141.77272727272725
1078,Cluster 25,2015-11,145,11,134,73.9090909090909
1079,Cluster 25,2015-12,164,9,155,87.61363636363636
1080,Cluster 26,2011-01,72,2,70,20.772727272727273
1081,Cluster 26,2011-02,51,3,48,2.6590909090909065
1082,Cluster 26,2011-03,80,1,79,21.977272727272727
1083,Cluster 26,2011-04,79,7,72,23.886363636363633
1084,Cluster 26,2011-05,103,2,101,38.727272727272734
1085,Cluster 26,2011-06,140,5,135,73.06818181818181
1086,Cluster 26,2011-07,139,9,130,70.47727272727273
1087,Cluster 26,2011-08,130,7,123,62.38636363636364
1088,Cluster 26,2011-09,187,4,183,119.63636363636364
1089,Cluster 26,2011-10,157,5,152,83.06818181818181
1090,Cluster 26,2011-11,147,6,141,78.63636363636364
1091,Cluster 26,2011-12,143,1,142,73.43181818181819
1092,Cluster 26,2012-01,133,6,127,65.54545454545455
1093,Cluster 26,2012-02,67,3,64,12.93181818181818
1094,Cluster 26,2012-03,90,5,85,33.13636363636363
1095,Cluster 26,2012-04,95,4,91,36.79545454545455
1096,Cluster 26,2012-05,131,10,121,64.43181818181819
1097,Cluster 26,2012-06,130,7,123,62.20454545454545
1098,Cluster 26,2012-07,155,7,148,81.81818181818181
1099,Cluster 26,2012-08,196,6,190,118.3409090909091
1100,Cluster 26,2012-09,189,6,183,118.8409090909091
1101,Cluster 26,2012-10,188,8,180,113.38636363636364
1102,Cluster 26,2012-11,107,4,103,41.56818181818181
1103,Cluster 26,2012-12,178,6,172,110.3409090909091
1104,Cluster 26,2013-01,170,5,165,106.27272727272728
1105,Cluster 26,2013-02,92,3,89,41.20454545454545
1106,Cluster 26,2013-03,94,4,90,35.52272727272727
1107,Cluster 26,2013-04,93,3,90,31.545454545454547
1108,Cluster 26,2013-05,152,5,147,79.63636363636364
1109,Cluster 26,2013-06,143,5,138,70.72727272727273
1110,Cluster 26,2013-07,140,4,136,67.68181818181819
1111,Cluster 26,2013-08,190,4,186,115.61363636363636
1112,Cluster 26,2013-09,188,3,185,111.88636363636364
1113,Cluster 26,2013-10,192,2,190,117.54545454545455
1114,Cluster 26,2013-11,171,3,168,104.02272727272727
1115,Cluster 26,2013-12,169,10,159,100.38636363636364
1116,Cluster 26,2014-01,174,6,168,108.97727272727273
1117,Cluster 26,2014-02,94,2,92,44.04545454545455
1118,Cluster 26,2014-03,100,7,93,44.22727272727273
1119,Cluster 26,2014-04,131,7,124,68.8409090909091
1120,Cluster 26,2014-05,186,6,180,114.13636363636364
1121,Cluster 26,2014-06,167,5,162,90.93181818181819
1122,Cluster 26,2014-07,205,6,199,120.8409090909091
1123,Cluster 26,2014-08,172,5,167,85.0
1124,Cluster 26,2014-09,159,7,152,74.88636363636364
1125,Cluster 26,2014-10,150,6,144,62.90909090909091
1126,Cluster 26,2014-11,122,8,114,46.56818181818181
1127,Cluster 26,2014-12,136,5,131,66.5
1128,Cluster 26,2015-01,135,7,128,69.72727272727273
1129,Cluster 26,2015-02,80,0,80,37.09090909090909
1130,Cluster 26,2015-03,113,3,110,56.75
1131,Cluster 26,2015-04,141,8,133,74.45454545454545
1132,Cluster 26,2015-05,192,9,183,116.0909090909091
1133,Cluster 26,2015-06,172,5,167,94.70454545454545
1134,Cluster 26,2015-07,206,8,198,123.5
1135,Cluster 26,2015-08,186,5,181,107.43181818181819
1136,Cluster 26,2015-09,170,8,162,96.18181818181819
1137,Cluster 26,2015-10,190,11,179,112.77272727272727
1138,Cluster 26,2015-11,139,9,130,67.9090909090909
1139,Cluster 26,2015-12,157,3,154,80.61363636363636
1140,Cluster 27,2011-01,8,0,8,-43.22727272727273
1141,Cluster 27,2011-02,7,1,6,-41.34090909090909
1142,Cluster 27,2011-03,14,3,11,-44.02272727272727
1143,Cluster 27,2011-04,12,1,11,-43.11363636363637
1144,Cluster 27,2011-05,23,0,23,-41.272727272727266
1145,Cluster 27,2011-06,15,0,15,-51.93181818181819
1146,Cluster 27,2011-07,15,1,14,-53.522727272727266
1147,Cluster 27,2011-08,13,1,12,-54.61363636363636
1148,Cluster 27,2011-09,18,1,17,-49.36363636363636
1149,Cluster 27,2011-10,13,1,12,-60.93181818181819
1150,Cluster 27,2011-11,13,0,13,-55.36363636363636
1151,Cluster 27,2011-12,17,1,16,-52.56818181818181
1152,Cluster 27,2012-01,16,1,15,-51.45454545454545
1153,Cluster 27,2012-02,8,1,7,-46.06818181818182
1154,Cluster 27,2012-03,11,0,11,-45.86363636363637
1155,Cluster 27,2012-04,17,0,17,-41.20454545454545
1156,Cluster 27,2012-05,17,2,15,-49.56818181818181
1157,Cluster 27,2012-06,16,1,15,-51.79545454545455
1158,Cluster 27,2012-07,18,0,18,-55.18181818181819
1159,Cluster 27,2012-08,26,0,26,-51.65909090909091
1160,Cluster 27,2012-09,12,0,12,-58.15909090909091
1161,Cluster 27,2012-10,10,0,10,-64.61363636363636
1162,Cluster 27,2012-11,16,0,16,-49.43181818181819
1163,Cluster 27,2012-12,6,1,5,-61.65909090909091
1164,Cluster 27,2013-01,11,0,11,-52.72727272727273
1165,Cluster 27,2013-02,8,0,8,-42.79545454545455
1166,Cluster 27,2013-03,8,0,8,-50.47727272727273
1167,Cluster 27,2013-04,12,0,12,-49.45454545454545
1168,Cluster 27,2013-05,16,0,16,-56.36363636363636
1169,Cluster 27,2013-06,20,2,18,-52.272727272727266
1170,Cluster 27,2013-07,32,0,32,-40.31818181818181
1171,Cluster 27,2013-08,19,1,18,-55.38636363636364
1172,Cluster 27,2013-09,33,12,21,-43.11363636363636
1173,Cluster 27,2013-10,12,0,12,-62.45454545454545
1174,Cluster 27,2013-11,14,0,14,-52.977272727272734
1175,Cluster 27,2013-12,12,0,12,-56.61363636363636
1176,Cluster 27,2014-01,12,2,10,-53.022727272727266
1177,Cluster 27,2014-02,5,1,4,-44.95454545454545
1178,Cluster 27,2014-03,12,0,12,-43.77272727272727
1179,Cluster 27,2014-04,6,0,6,-56.15909090909091
1180,Cluster 27,2014-05,19,1,18,-52.86363636363636
1181,Cluster 27,2014-06,31,1,30,-45.06818181818181
1182,Cluster 27,2014-07,30,0,30,-54.15909090909091
1183,Cluster 27,2014-08,22,0,22,-65.0
1184,Cluster 27,2014-09,25,0,25,-59.11363636363636
1185,Cluster 27,2014-10,18,0,18,-69.0909090909091
1186,Cluster 27,2014-11,17,0,17,-58.43181818181819
1187,Cluster 27,2014-12,18,0,18,-51.5
1188,Cluster 27,2015-01,19,2,17,-46.272727272727266
1189,Cluster 27,2015-02,11,0,11,-31.909090909090907
1190,Cluster 27,2015-03,13,0,13,-43.25
1191,Cluster 27,2015-04,14,0,14,-52.54545454545455
1192,Cluster 27,2015-05,21,2,19,-54.90909090909091
1193,Cluster 27,2015-06,26,2,24,-51.29545454545455
1194,Cluster 27,2015-07,16,0,16,-66.5
1195,Cluster 27,2015-08,18,1,17,-60.56818181818181
1196,Cluster 27,2015-09,18,0,18,-55.81818181818181
1197,Cluster 27,2015-10,39,0,39,-38.227272727272734
1198,Cluster 27,2015-11,28,0,28,-43.09090909090909
1199,Cluster 27,2015-12,26,1,25,-50.38636363636364
1200,Cluster 28,2011-01,37,4,33,-14.227272727272727
1201,Cluster 28,2011-02,33,2,31,-15.340909090909093
1202,Cluster 28,2011-03,23,4,19,-35.02272727272727
1203,Cluster 28,2011-04,32,6,26,-23.113636363636367
1204,Cluster 28,2011-05,35,10,25,-29.272727272727266
1205,Cluster 28,2011-06,31,7,24,-35.93181818181819
1206,Cluster 28,2011-07,34,6,28,-34.522727272727266
1207,Cluster 28,2011-08,30,7,23,-37.61363636363636
1208,Cluster 28,2011-09,34,7,27,-33.36363636363636
1209,Cluster 28,2011-10,29,1,28,-44.93181818181819
1210,Cluster 28,2011-11,39,4,35,-29.36363636363636
1211,Cluster 28,2011-12,46,10,36,-23.568181818181813
1212,Cluster 28,2012-01,31,1,30,-36.45454545454545
1213,Cluster 28,2012-02,40,9,31,-14.06818181818182
1214,Cluster 28,2012-03,31,2,29,-25.863636363636367
1215,Cluster 28,2012-04,30,4,26,-28.204545454545453
1216,Cluster 28,2012-05,45,10,35,-21.568181818181813
1217,Cluster 28,2012-06,46,7,39,-21.795454545454547
1218,Cluster 28,2012-07,31,4,27,-42.18181818181819
1219,Cluster 28,2012-08,33,7,26,-44.65909090909091
1220,Cluster 28,2012-09,41,11,30,-29.159090909090907
1221,Cluster 28,2012-10,28,2,26,-46.61363636363636
1222,Cluster 28,2012-11,30,3,27,-35.43181818181819
1223,Cluster 28,2012-12,24,4,20,-43.65909090909091
1224,Cluster 28,2013-01,22,6,16,-41.72727272727273
1225,Cluster 28,2013-02,31,6,25,-19.795454545454547
1226,Cluster 28,2013-03,30,4,26,-28.477272727272727
1227,Cluster 28,2013-04,27,3,24,-34.45454545454545
1228,Cluster 28,2013-05,23,2,21,-49.36363636363636
1229,Cluster 28,2013-06,40,5,35,-32.272727272727266
1230,Cluster 28,2013-07,44,8,36,-28.318181818181813
1231,Cluster 28,2013-08,51,6,45,-23.38636363636364
1232,Cluster 28,2013-09,52,11,41,-24.11363636363636
1233,Cluster 28,2013-10,46,7,39,-28.454545454545453
1234,Cluster 28,2013-11,37,7,30,-29.977272727272734
1235,Cluster 28,2013-12,29,6,23,-39.61363636363636
1236,Cluster 28,2014-01,34,1,33,-31.022727272727266
1237,Cluster 28,2014-02,36,7,29,-13.954545454545453
1238,Cluster 28,2014-03,31,8,23,-24.772727272727273
1239,Cluster 28,2014-04,34,7,27,-28.159090909090907
1240,Cluster 28,2014-05,34,6,28,-37.86363636363636
1241,Cluster 28,2014-06,26,4,22,-50.06818181818181
1242,Cluster 28,2014-07,28,5,23,-56.15909090909091
1243,Cluster 28,2014-08,43,5,38,-44.0
1244,Cluster 28,2014-09,47,9,38,-37.11363636363636
1245,Cluster 28,2014-10,70,9,61,-17.090909090909093
1246,Cluster 28,2014-11,38,3,35,-37.43181818181819
1247,Cluster 28,2014-12,47,2,45,-22.5
1248,Cluster 28,2015-01,37,4,33,-28.272727272727266
1249,Cluster 28,2015-02,20,3,17,-22.909090909090907
1250,Cluster 28,2015-03,29,3,26,-27.25
1251,Cluster 28,2015-04,28,4,24,-38.54545454545455
1252,Cluster 28,2015-05,36,7,29,-39.90909090909091
1253,Cluster 28,2015-06,37,4,33,-40.29545454545455
1254,Cluster 28,2015-07,51,8,43,-31.5
1255,Cluster 28,2015-08,39,9,30,-39.56818181818181
1256,Cluster 28,2015-09,48,7,41,-25.818181818181813
1257,Cluster 28,2015-10,42,7,35,-35.227272727272734
1258,Cluster 28,2015-11,26,3,23,-45.09090909090909
1259,Cluster 28,2015-12,43,8,35,-33.38636363636364
1260,Cluster 29,2011-01,6,0,6,-45.22727272727273
1261,Cluster 29,2011-02,5,1,4,-43.34090909090909
1262,Cluster 29,2011-03,2,0,2,-56.02272727272727
1263,Cluster 29,2011-04,3,0,3,-52.11363636363637
1264,Cluster 29,2011-05,10,0,10,-54.272727272727266
1265,Cluster 29,2011-06,8,0,8,-58.93181818181819
1266,Cluster 29,2011-07,6,0,6,-62.522727272727266
1267,Cluster 29,2011-08,9,1,8,-58.61363636363636
1268,Cluster 29,2011-09,6,1,5,-61.36363636363636
1269,Cluster 29,2011-10,7,3,4,-66.93181818181819
1270,Cluster 29,2011-11,7,2,5,-61.36363636363636
1271,Cluster 29,2011-12,13,3,10,-56.56818181818181
1272,Cluster 29,2012-01,8,3,5,-59.45454545454545
1273,Cluster 29,2012-02,5,1,4,-49.06818181818182
1274,Cluster 29,2012-03,9,3,6,-47.86363636363637
1275,Cluster 29,2012-04,13,4,9,-45.20454545454545
1276,Cluster 29,2012-05,12,4,8,-54.56818181818181
1277,Cluster 29,2012-06,14,2,12,-53.79545454545455
1278,Cluster 29,2012-07,18,1,17,-55.18181818181819
1279,Cluster 29,2012-08,13,2,11,-64.6590909090909
1280,Cluster 29,2012-09,16,4,12,-54.15909090909091
1281,Cluster 29,2012-10,8,1,7,-66.61363636363636
1282,Cluster 29,2012-11,11,1,10,-54.43181818181819
1283,Cluster 29,2012-12,14,2,12,-53.65909090909091
1284,Cluster 29,2013-01,13,2,11,-50.72727272727273
1285,Cluster 29,2013-02,4,0,4,-46.79545454545455
1286,Cluster 29,2013-03,6,0,6,-52.47727272727273
1287,Cluster 29,2013-04,5,1,4,-56.45454545454545
1288,Cluster 29,2013-05,9,0,9,-63.36363636363636
1289,Cluster 29,2013-06,13,4,9,-59.272727272727266
1290,Cluster 29,2013-07,5,1,4,-67.31818181818181
1291,Cluster 29,2013-08,11,3,8,-63.38636363636364
1292,Cluster 29,2013-09,14,1,13,-62.11363636363636
1293,Cluster 29,2013-10,18,4,14,-56.45454545454545
1294,Cluster 29,2013-11,6,1,5,-60.977272727272734
1295,Cluster 29,2013-12,6,1,5,-62.61363636363636
1296,Cluster 29,2014-01,12,2,10,-53.022727272727266
1297,Cluster 29,2014-02,7,3,4,-42.95454545454545
1298,Cluster 29,2014-03,7,3,4,-48.77272727272727
1299,Cluster 29,2014-04,9,3,6,-53.15909090909091
1300,Cluster 29,2014-05,14,6,8,-57.86363636363636
1301,Cluster 29,2014-06,8,5,3,-68.06818181818181
1302,Cluster 29,2014-07,14,2,12,-70.1590909090909
1303,Cluster 29,2014-08,18,4,14,-69.0
1304,Cluster 29,2014-09,20,4,16,-64.11363636363636
1305,Cluster 29,2014-10,14,6,8,-73.0909090909091
1306,Cluster 29,2014-11,14,2,12,-61.43181818181819
1307,Cluster 29,2014-12,9,6,3,-60.5
1308,Cluster 29,2015-01,7,0,7,-58.272727272727266
1309,Cluster 29,2015-02,3,1,2,-39.90909090909091
1310,Cluster 29,2015-03,2,0,2,-54.25
1311,Cluster 29,2015-04,6,0,6,-60.54545454545455
1312,Cluster 29,2015-05,5,1,4,-70.9090909090909
1313,Cluster 29,2015-06,6,1,5,-71.29545454545455
1314,Cluster 29,2015-07,13,3,10,-69.5
1315,Cluster 29,2015-08,12,2,10,-66.56818181818181
1316,Cluster 29,2015-09,5,0,5,-68.81818181818181
1317,Cluster 29,2015-10,9,1,8,-68.22727272727273
1318,Cluster 29,2015-11,5,1,4,-66.0909090909091
1319,Cluster 29,2015-12,8,4,4,-68.38636363636364
1320,Cluster 3,2011-01,70,5,65,18.772727272727273
1321,Cluster 3,2011-02,100,5,95,51.65909090909091
1322,Cluster 3,2011-03,122,5,117,63.97727272727273
1323,Cluster 3,2011-04,103,7,96,47.88636363636363
1324,Cluster 3,2011-05,107,13,94,42.727272727272734
1325,Cluster 3,2011-06,89,7,82,22.068181818181813
1326,Cluster 3,2011-07,79,1,78,10.477272727272734
1327,Cluster 3,2011-08,92,5,87,24.38636363636364
1328,Cluster 3,2011-09,107,7,100,39.63636363636364
1329,Cluster 3,2011-10,183,5,178,109.06818181818181
1330,Cluster 3,2011-11,107,3,104,38.63636363636364
1331,Cluster 3,2011-12,122,8,114,52.43181818181819
1332,Cluster 3,2012-01,115,7,108,47.54545454545455
1333,Cluster 3,2012-02,110,10,100,55.93181818181818
1334,Cluster 3,2012-03,101,7,94,44.13636363636363
1335,Cluster 3,2012-04,96,8,88,37.79545454545455
1336,Cluster 3,2012-05,116,4,112,49.43181818181819
1337,Cluster 3,2012-06,122,5,117,54.20454545454545
1338,Cluster 3,2012-07,135,10,125,61.81818181818181
1339,Cluster 3,2012-08,139,11,128,61.34090909090909
1340,Cluster 3,2012-09,131,9,122,60.84090909090909
1341,Cluster 3,2012-10,133,6,127,58.38636363636364
1342,Cluster 3,2012-11,149,4,145,83.56818181818181
1343,Cluster 3,2012-12,143,7,136,75.3409090909091
1344,Cluster 3,2013-01,104,3,101,40.27272727272727
1345,Cluster 3,2013-02,86,8,78,35.20454545454545
1346,Cluster 3,2013-03,158,7,151,99.52272727272728
1347,Cluster 3,2013-04,168,8,160,106.54545454545455
1348,Cluster 3,2013-05,121,7,114,48.63636363636364
1349,Cluster 3,2013-06,136,11,125,63.727272727272734
1350,Cluster 3,2013-07,118,7,111,45.68181818181819
1351,Cluster 3,2013-08,103,5,98,28.61363636363636
1352,Cluster 3,2013-09,98,3,95,21.88636363636364
1353,Cluster 3,2013-10,134,7,127,59.54545454545455
1354,Cluster 3,2013-11,117,5,112,50.022727272727266
1355,Cluster 3,2013-12,112,7,105,43.38636363636364
1356,Cluster 3,2014-01,117,5,112,51.977272727272734
1357,Cluster 3,2014-02,91,2,89,41.04545454545455
1358,Cluster 3,2014-03,113,2,111,57.22727272727273
1359,Cluster 3,2014-04,109,2,107,46.84090909090909
1360,Cluster 3,2014-05,107,6,101,35.13636363636364
1361,Cluster 3,2014-06,136,9,127,59.93181818181819
1362,Cluster 3,2014-07,159,13,146,74.8409090909091
1363,Cluster 3,2014-08,149,8,141,62.0
1364,Cluster 3,2014-09,149,9,140,64.88636363636364
1365,Cluster 3,2014-10,166,8,158,78.9090909090909
1366,Cluster 3,2014-11,124,2,122,48.56818181818181
1367,Cluster 3,2014-12,110,6,104,40.5
1368,Cluster 3,2015-01,100,3,97,34.727272727272734
1369,Cluster 3,2015-02,83,2,81,40.09090909090909
1370,Cluster 3,2015-03,81,4,77,24.75
1371,Cluster 3,2015-04,115,6,109,48.45454545454545
1372,Cluster 3,2015-05,138,2,136,62.09090909090909
1373,Cluster 3,2015-06,113,6,107,35.70454545454545
1374,Cluster 3,2015-07,158,7,151,75.5
1375,Cluster 3,2015-08,132,8,124,53.43181818181819
1376,Cluster 3,2015-09,129,12,117,55.18181818181819
1377,Cluster 3,2015-10,135,3,132,57.772727272727266
1378,Cluster 3,2015-11,141,6,135,69.9090909090909
1379,Cluster 3,2015-12,131,5,126,54.61363636363636
1380,Cluster 30,2011-01,37,6,31,-14.227272727272727
1381,Cluster 30,2011-02,18,2,16,-30.340909090909093
1382,Cluster 30,2011-03,37,7,30,-21.022727272727273
1383,Cluster 30,2011-04,23,3,20,-32.11363636363637
1384,Cluster 30,2011-05,34,8,26,-30.272727272727266
1385,Cluster 30,2011-06,34,5,29,-32.93181818181819
1386,Cluster 30,2011-07,40,6,34,-28.522727272727266
1387,Cluster 30,2011-08,45,6,39,-22.61363636363636
1388,Cluster 30,2011-09,37,6,31,-30.36363636363636
1389,Cluster 30,2011-10,38,6,32,-35.93181818181819
1390,Cluster 30,2011-11,43,11,32,-25.36363636363636
1391,Cluster 30,2011-12,33,2,31,-36.56818181818181
1392,Cluster 30,2012-01,36,2,34,-31.454545454545453
1393,Cluster 30,2012-02,24,3,21,-30.06818181818182
1394,Cluster 30,2012-03,34,4,30,-22.863636363636367
1395,Cluster 30,2012-04,36,7,29,-22.204545454545453
1396,Cluster 30,2012-05,20,2,18,-46.56818181818181
1397,Cluster 30,2012-06,36,1,35,-31.795454545454547
1398,Cluster 30,2012-07,33,3,30,-40.18181818181819
1399,Cluster 30,2012-08,49,7,42,-28.659090909090907
1400,Cluster 30,2012-09,48,7,41,-22.159090909090907
1401,Cluster 30,2012-10,35,6,29,-39.61363636363636
1402,Cluster 30,2012-11,34,1,33,-31.431818181818187
1403,Cluster 30,2012-12,33,2,31,-34.65909090909091
1404,Cluster 30,2013-01,37,7,30,-26.727272727272727
1405,Cluster 30,2013-02,40,11,29,-10.795454545454547
1406,Cluster 30,2013-03,35,0,35,-23.477272727272727
1407,Cluster 30,2013-04,36,1,35,-25.454545454545453
1408,Cluster 30,2013-05,64,9,55,-8.36363636363636
1409,Cluster 30,2013-06,41,4,37,-31.272727272727266
1410,Cluster 30,2013-07,46,8,38,-26.318181818181813
1411,Cluster 30,2013-08,40,8,32,-34.38636363636364
1412,Cluster 30,2013-09,32,8,24,-44.11363636363636
1413,Cluster 30,2013-10,46,5,41,-28.454545454545453
1414,Cluster 30,2013-11,41,5,36,-25.977272727272734
1415,Cluster 30,2013-12,40,1,39,-28.61363636363636
1416,Cluster 30,2014-01,28,3,25,-37.022727272727266
1417,Cluster 30,2014-02,38,7,31,-11.954545454545453
1418,Cluster 30,2014-03,43,9,34,-12.772727272727273
1419,Cluster 30,2014-04,32,5,27,-30.159090909090907
1420,Cluster 30,2014-05,36,7,29,-35.86363636363636
1421,Cluster 30,2014-06,39,8,31,-37.06818181818181
1422,Cluster 30,2014-07,50,8,42,-34.15909090909091
1423,Cluster 30,2014-08,52,6,46,-35.0
1424,Cluster 30,2014-09,52,10,42,-32.11363636363636
1425,Cluster 30,2014-10,58,6,52,-29.090909090909093
1426,Cluster 30,2014-11,48,10,38,-27.431818181818187
1427,Cluster 30,2014-12,57,7,50,-12.5
1428,Cluster 30,2015-01,47,12,35,-18.272727272727266
1429,Cluster 30,2015-02,18,3,15,-24.909090909090907
1430,Cluster 30,2015-03,37,13,24,-19.25
1431,Cluster 30,2015-04,35,1,34,-31.545454545454547
1432,Cluster 30,2015-05,33,7,26,-42.90909090909091
1433,Cluster 30,2015-06,45,5,40,-32.29545454545455
1434,Cluster 30,2015-07,45,9,36,-37.5
1435,Cluster 30,2015-08,47,7,40,-31.568181818181813
1436,Cluster 30,2015-09,39,4,35,-34.81818181818181
1437,Cluster 30,2015-10,51,9,42,-26.227272727272734
1438,Cluster 30,2015-11,33,4,29,-38.09090909090909
1439,Cluster 30,2015-12,42,4,38,-34.38636363636364
1440,Cluster 31,2011-01,63,8,55,11.772727272727273
1441,Cluster 31,2011-02,41,3,38,-7.3409090909090935
1442,Cluster 31,2011-03,77,8,69,18.977272727272727
1443,Cluster 31,2011-04,83,13,70,27.886363636363633
1444,Cluster 31,2011-05,91,17,74,26.727272727272734
1445,Cluster 31,2011-06,129,20,109,62.06818181818181
1446,Cluster 31,2011-07,109,18,91,40.477272727272734
1447,Cluster 31,2011-08,74,10,64,6.38636363636364
1448,Cluster 31,2011-09,74,17,57,6.63636363636364
1449,Cluster 31,2011-10,87,10,77,13.068181818181813
1450,Cluster 31,2011-11,95,15,80,26.63636363636364
1451,Cluster 31,2011-12,98,12,86,28.431818181818187
1452,Cluster 31,2012-01,63,5,58,-4.454545454545453
1453,Cluster 31,2012-02,45,4,41,-9.06818181818182
1454,Cluster 31,2012-03,63,6,57,6.136363636363633
1455,Cluster 31,2012-04,74,9,65,15.795454545454547
1456,Cluster 31,2012-05,71,8,63,4.431818181818187
1457,Cluster 31,2012-06,76,11,65,8.204545454545453
1458,Cluster 31,2012-07,77,14,63,3.818181818181813
1459,Cluster 31,2012-08,87,8,79,9.340909090909093
1460,Cluster 31,2012-09,75,13,62,4.8409090909090935
1461,Cluster 31,2012-10,83,7,76,8.38636363636364
1462,Cluster 31,2012-11,64,11,53,-1.431818181818187
1463,Cluster 31,2012-12,89,9,80,21.340909090909093
1464,Cluster 31,2013-01,81,8,73,17.272727272727273
1465,Cluster 31,2013-02,73,6,67,22.204545454545453
1466,Cluster 31,2013-03,68,17,51,9.522727272727273
1467,Cluster 31,2013-04,80,13,67,18.545454545454547
1468,Cluster 31,2013-05,93,15,78,20.63636363636364
1469,Cluster 31,2013-06,82,20,62,9.727272727272734
1470,Cluster 31,2013-07,86,12,74,13.681818181818187
1471,Cluster 31,2013-08,80,19,61,5.61363636363636
1472,Cluster 31,2013-09,76,9,67,-0.11363636363635976
1473,Cluster 31,2013-10,98,13,85,23.545454545454547
1474,Cluster 31,2013-11,76,11,65,9.022727272727266
1475,Cluster 31,2013-12,89,14,75,20.38636363636364
1476,Cluster 31,2014-01,71,12,59,5.977272727272734
1477,Cluster 31,2014-02,63,9,54,13.045454545454547
1478,Cluster 31,2014-03,82,14,68,26.227272727272727
1479,Cluster 31,2014-04,71,11,60,8.840909090909093
1480,Cluster 31,2014-05,96,15,81,24.13636363636364
1481,Cluster 31,2014-06,114,16,98,37.93181818181819
1482,Cluster 31,2014-07,127,24,103,42.84090909090909
1483,Cluster 31,2014-08,121,19,102,34.0
1484,Cluster 31,2014-09,119,17,102,34.88636363636364
1485,Cluster 31,2014-10,116,7,109,28.909090909090907
1486,Cluster 31,2014-11,114,15,99,38.56818181818181
1487,Cluster 31,2014-12,95,14,81,25.5
1488,Cluster 31,2015-01,87,11,76,21.727272727272734
1489,Cluster 31,2015-02,53,10,43,10.090909090909093
1490,Cluster 31,2015-03,78,20,58,21.75
1491,Cluster 31,2015-04,74,12,62,7.454545454545453
1492,Cluster 31,2015-05,98,18,80,22.090909090909093
1493,Cluster 31,2015-06,91,10,81,13.704545454545453
1494,Cluster 31,2015-07,95,17,78,12.5
1495,Cluster 31,2015-08,103,18,85,24.431818181818187
1496,Cluster 31,2015-09,84,16,68,10.181818181818187
1497,Cluster 31,2015-10,90,13,77,12.772727272727266
1498,Cluster 31,2015-11,70,13,57,-1.0909090909090935
1499,Cluster 31,2015-12,93,19,74,16.61363636363636
1500,Cluster 32,2011-01,75,7,68,23.772727272727273
1501,Cluster 32,2011-02,55,6,49,6.6590909090909065
1502,Cluster 32,2011-03,43,11,32,-15.022727272727273
1503,Cluster 32,2011-04,55,7,48,-0.11363636363636687
1504,Cluster 32,2011-05,70,9,61,5.727272727272734
1505,Cluster 32,2011-06,73,11,62,6.068181818181813
1506,Cluster 32,2011-07,78,4,74,9.477272727272734
1507,Cluster 32,2011-08,63,8,55,-4.61363636363636
1508,Cluster 32,2011-09,68,10,58,0.6363636363636402
1509,Cluster 32,2011-10,55,8,47,-18.931818181818187
1510,Cluster 32,2011-11,65,8,57,-3.3636363636363598
1511,Cluster 32,2011-12,78,13,65,8.431818181818187
1512,Cluster 32,2012-01,54,9,45,-13.454545454545453
1513,Cluster 32,2012-02,59,12,47,4.93181818181818
1514,Cluster 32,2012-03,56,4,52,-0.8636363636363669
1515,Cluster 32,2012-04,57,10,47,-1.2045454545454533
1516,Cluster 32,2012-05,81,13,68,14.431818181818187
1517,Cluster 32,2012-06,73,14,59,5.204545454545453
1518,Cluster 32,2012-07,73,6,67,-0.18181818181818699
1519,Cluster 32,2012-08,86,8,78,8.340909090909093
1520,Cluster 32,2012-09,75,15,60,4.8409090909090935
1521,Cluster 32,2012-10,80,13,67,5.38636363636364
1522,Cluster 32,2012-11,93,10,83,27.568181818181813
1523,Cluster 32,2012-12,87,12,75,19.340909090909093
1524,Cluster 32,2013-01,81,7,74,17.272727272727273
1525,Cluster 32,2013-02,71,14,57,20.204545454545453
1526,Cluster 32,2013-03,68,10,58,9.522727272727273
1527,Cluster 32,2013-04,74,6,68,12.545454545454547
1528,Cluster 32,2013-05,92,15,77,19.63636363636364
1529,Cluster 32,2013-06,75,15,60,2.7272727272727337
1530,Cluster 32,2013-07,92,15,77,19.681818181818187
1531,Cluster 32,2013-08,76,11,65,1.6136363636363598
1532,Cluster 32,2013-09,69,7,62,-7.11363636363636
1533,Cluster 32,2013-10,77,9,68,2.5454545454545467
1534,Cluster 32,2013-11,70,12,58,3.0227272727272663
1535,Cluster 32,2013-12,72,11,61,3.3863636363636402
1536,Cluster 32,2014-01,71,7,64,5.977272727272734
1537,Cluster 32,2014-02,62,7,55,12.045454545454547
1538,Cluster 32,2014-03,65,12,53,9.227272727272727
1539,Cluster 32,2014-04,95,12,83,32.84090909090909
1540,Cluster 32,2014-05,92,12,80,20.13636363636364
1541,Cluster 32,2014-06,99,9,90,22.931818181818187
1542,Cluster 32,2014-07,106,13,93,21.840909090909093
1543,Cluster 32,2014-08,106,19,87,19.0
1544,Cluster 32,2014-09,91,16,75,6.88636363636364
1545,Cluster 32,2014-10,87,10,77,-0.09090909090909349
1546,Cluster 32,2014-11,79,9,70,3.568181818181813
1547,Cluster 32,2014-12,89,10,79,19.5
1548,Cluster 32,2015-01,82,12,70,16.727272727272734
1549,Cluster 32,2015-02,51,9,42,8.090909090909093
1550,Cluster 32,2015-03,58,10,48,1.75
1551,Cluster 32,2015-04,67,9,58,0.45454545454545325
1552,Cluster 32,2015-05,79,12,67,3.0909090909090935
1553,Cluster 32,2015-06,96,9,87,18.704545454545453
1554,Cluster 32,2015-07,86,11,75,3.5
1555,Cluster 32,2015-08,79,9,70,0.431818181818187
1556,Cluster 32,2015-09,101,11,90,27.181818181818187
1557,Cluster 32,2015-10,95,16,79,17.772727272727266
1558,Cluster 32,2015-11,81,13,68,9.909090909090907
1559,Cluster 32,2015-12,96,11,85,19.61363636363636
1560,Cluster 33,2011-01,71,13,58,19.772727272727273
1561,Cluster 33,2011-02,54,6,48,5.6590909090909065
1562,Cluster 33,2011-03,67,8,59,8.977272727272727
1563,Cluster 33,2011-04,42,6,36,-13.113636363636367
1564,Cluster 33,2011-05,59,5,54,-5.272727272727266
1565,Cluster 33,2011-06,76,6,70,9.068181818181813
1566,Cluster 33,2011-07,78,14,64,9.477272727272734
1567,Cluster 33,2011-08,71,5,66,3.3863636363636402
1568,Cluster 33,2011-09,82,10,72,14.63636363636364
1569,Cluster 33,2011-10,82,5,77,8.068181818181813
1570,Cluster 33,2011-11,107,8,99,38.63636363636364
1571,Cluster 33,2011-12,101,15,86,31.431818181818187
1572,Cluster 33,2012-01,82,8,74,14.545454545454547
1573,Cluster 33,2012-02,52,7,45,-2.06818181818182
1574,Cluster 33,2012-03,61,4,57,4.136363636363633
1575,Cluster 33,2012-04,91,14,77,32.79545454545455
1576,Cluster 33,2012-05,83,14,69,16.431818181818187
1577,Cluster 33,2012-06,60,13,47,-7.795454545454547
1578,Cluster 33,2012-07,75,11,64,1.818181818181813
1579,Cluster 33,2012-08,111,12,99,33.34090909090909
1580,Cluster 33,2012-09,82,15,67,11.840909090909093
1581,Cluster 33,2012-10,103,11,92,28.38636363636364
1582,Cluster 33,2012-11,60,9,51,-5.431818181818187
1583,Cluster 33,2012-12,101,9,92,33.34090909090909
1584,Cluster 33,2013-01,105,23,82,41.27272727272727
1585,Cluster 33,2013-02,62,7,55,11.204545454545453
1586,Cluster 33,2013-03,69,9,60,10.522727272727273
1587,Cluster 33,2013-04,70,14,56,8.545454545454547
1588,Cluster 33,2013-05,85,13,72,12.63636363636364
1589,Cluster 33,2013-06,110,18,92,37.727272727272734
1590,Cluster 33,2013-07,82,18,64,9.681818181818187
1591,Cluster 33,2013-08,105,14,91,30.61363636363636
1592,Cluster 33,2013-09,98,16,82,21.88636363636364
1593,Cluster 33,2013-10,117,23,94,42.54545454545455
1594,Cluster 33,2013-11,95,17,78,28.022727272727266
1595,Cluster 33,2013-12,91,12,79,22.38636363636364
1596,Cluster 33,2014-01,96,13,83,30.977272727272734
1597,Cluster 33,2014-02,81,12,69,31.045454545454547
1598,Cluster 33,2014-03,81,16,65,25.227272727272727
1599,Cluster 33,2014-04,85,14,71,22.840909090909093
1600,Cluster 33,2014-05,106,14,92,34.13636363636364
1601,Cluster 33,2014-06,78,13,65,1.931818181818187
1602,Cluster 33,2014-07,104,19,85,19.840909090909093
1603,Cluster 33,2014-08,95,19,76,8.0
1604,Cluster 33,2014-09,99,23,76,14.88636363636364
1605,Cluster 33,2014-10,124,18,106,36.90909090909091
1606,Cluster 33,2014-11,100,12,88,24.568181818181813
1607,Cluster 33,2014-12,89,11,78,19.5
1608,Cluster 33,2015-01,101,12,89,35.727272727272734
1609,Cluster 33,2015-02,54,3,51,11.090909090909093
1610,Cluster 33,2015-03,89,15,74,32.75
1611,Cluster 33,2015-04,80,15,65,13.454545454545453
1612,Cluster 33,2015-05,87,11,76,11.090909090909093
1613,Cluster 33,2015-06,96,22,74,18.704545454545453
1614,Cluster 33,2015-07,78,15,63,-4.5
1615,Cluster 33,2015-08,70,17,53,-8.568181818181813
1616,Cluster 33,2015-09,89,12,77,15.181818181818187
1617,Cluster 33,2015-10,74,12,62,-3.2272727272727337
1618,Cluster 33,2015-11,86,16,70,14.909090909090907
1619,Cluster 33,2015-12,96,19,77,19.61363636363636
1620,Cluster 34,2011-01,50,6,44,-1.2272727272727266
1621,Cluster 34,2011-02,52,6,46,3.6590909090909065
1622,Cluster 34,2011-03,47,11,36,-11.022727272727273
1623,Cluster 34,2011-04,55,12,43,-0.11363636363636687
1624,Cluster 34,2011-05,57,9,48,-7.272727272727266
1625,Cluster 34,2011-06,69,8,61,2.068181818181813
1626,Cluster 34,2011-07,80,11,69,11.477272727272734
1627,Cluster 34,2011-08,75,13,62,7.38636363636364
1628,Cluster 34,2011-09,75,11,64,7.63636363636364
1629,Cluster 34,2011-10,70,11,59,-3.931818181818187
1630,Cluster 34,2011-11,75,6,69,6.63636363636364
1631,Cluster 34,2011-12,53,4,49,-16.568181818181813
1632,Cluster 34,2012-01,79,13,66,11.545454545454547
1633,Cluster 34,2012-02,58,9,49,3.93181818181818
1634,Cluster 34,2012-03,76,13,63,19.136363636363633
1635,Cluster 34,2012-04,80,5,75,21.795454545454547
1636,Cluster 34,2012-05,83,13,70,16.431818181818187
1637,Cluster 34,2012-06,79,9,70,11.204545454545453
1638,Cluster 34,2012-07,79,12,67,5.818181818181813
1639,Cluster 34,2012-08,108,14,94,30.340909090909093
1640,Cluster 34,2012-09,75,6,69,4.8409090909090935
1641,Cluster 34,2012-10,84,12,72,9.38636363636364
1642,Cluster 34,2012-11,45,7,38,-20.431818181818187
1643,Cluster 34,2012-12,89,10,79,21.340909090909093
1644,Cluster 34,2013-01,73,8,65,9.272727272727273
1645,Cluster 34,2013-02,49,7,42,-1.7954545454545467
1646,Cluster 34,2013-03,74,11,63,15.522727272727273
1647,Cluster 34,2013-04,80,8,72,18.545454545454547
1648,Cluster 34,2013-05,79,9,70,6.63636363636364
1649,Cluster 34,2013-06,85,18,67,12.727272727272734
1650,Cluster 34,2013-07,77,12,65,4.681818181818187
1651,Cluster 34,2013-08,89,17,72,14.61363636363636
1652,Cluster 34,2013-09,88,18,70,11.88636363636364
1653,Cluster 34,2013-10,76,11,65,1.5454545454545467
1654,Cluster 34,2013-11,73,7,66,6.022727272727266
1655,Cluster 34,2013-12,96,13,83,27.38636363636364
1656,Cluster 34,2014-01,80,14,66,14.977272727272734
1657,Cluster 34,2014-02,64,3,61,14.045454545454547
1658,Cluster 34,2014-03,56,5,51,0.22727272727272663
1659,Cluster 34,2014-04,61,13,48,-1.1590909090909065
1660,Cluster 34,2014-05,90,8,82,18.13636363636364
1661,Cluster 34,2014-06,92,13,79,15.931818181818187
1662,Cluster 34,2014-07,118,9,109,33.84090909090909
1663,Cluster 34,2014-08,62,12,50,-25.0
1664,Cluster 34,2014-09,110,12,98,25.88636363636364
1665,Cluster 34,2014-10,99,14,85,11.909090909090907
1666,Cluster 34,2014-11,97,10,87,21.568181818181813
1667,Cluster 34,2014-12,84,8,76,14.5
1668,Cluster 34,2015-01,89,9,80,23.727272727272734
1669,Cluster 34,2015-02,48,5,43,5.0909090909090935
1670,Cluster 34,2015-03,64,13,51,7.75
1671,Cluster 34,2015-04,66,9,57,-0.5454545454545467
1672,Cluster 34,2015-05,57,8,49,-18.909090909090907
1673,Cluster 34,2015-06,95,17,78,17.704545454545453
1674,Cluster 34,2015-07,99,14,85,16.5
1675,Cluster 34,2015-08,69,11,58,-9.568181818181813
1676,Cluster 34,2015-09,53,5,48,-20.818181818181813
1677,Cluster 34,2015-10,86,8,78,8.772727272727266
1678,Cluster 34,2015-11,71,10,61,-0.09090909090909349
1679,Cluster 34,2015-12,82,12,70,5.61363636363636
1680,Cluster 35,2011-01,17,2,15,-34.22727272727273
1681,Cluster 35,2011-02,18,2,16,-30.340909090909093
1682,Cluster 35,2011-03,25,2,23,-33.02272727272727
1683,Cluster 35,2011-04,23,3,20,-32.11363636363637
1684,Cluster 35,2011-05,18,2,16,-46.272727272727266
1685,Cluster 35,2011-06,25,0,25,-41.93181818181819
1686,Cluster 35,2011-07,32,3,29,-36.522727272727266
1687,Cluster 35,2011-08,30,1,29,-37.61363636363636
1688,Cluster 35,2011-09,25,1,24,-42.36363636363636
1689,Cluster 35,2011-10,36,3,33,-37.93181818181819
1690,Cluster 35,2011-11,26,3,23,-42.36363636363636
1691,Cluster 35,2011-12,35,4,31,-34.56818181818181
1692,Cluster 35,2012-01,35,0,35,-32.45454545454545
1693,Cluster 35,2012-02,34,4,30,-20.06818181818182
1694,Cluster 35,2012-03,24,2,22,-32.86363636363637
1695,Cluster 35,2012-04,31,3,28,-27.204545454545453
1696,Cluster 35,2012-05,27,1,26,-39.56818181818181
1697,Cluster 35,2012-06,31,0,31,-36.79545454545455
1698,Cluster 35,2012-07,43,2,41,-30.181818181818187
1699,Cluster 35,2012-08,39,0,39,-38.65909090909091
1700,Cluster 35,2012-09,45,1,44,-25.159090909090907
1701,Cluster 35,2012-10,40,5,35,-34.61363636363636
1702,Cluster 35,2012-11,31,2,29,-34.43181818181819
1703,Cluster 35,2012-12,38,4,34,-29.659090909090907
1704,Cluster 35,2013-01,30,4,26,-33.72727272727273
1705,Cluster 35,2013-02,23,4,19,-27.795454545454547
1706,Cluster 35,2013-03,36,1,35,-22.477272727272727
1707,Cluster 35,2013-04,37,0,37,-24.454545454545453
1708,Cluster 35,2013-05,35,2,33,-37.36363636363636
1709,Cluster 35,2013-06,30,1,29,-42.272727272727266
1710,Cluster 35,2013-07,29,1,28,-43.31818181818181
1711,Cluster 35,2013-08,28,4,24,-46.38636363636364
1712,Cluster 35,2013-09,37,5,32,-39.11363636363636
1713,Cluster 35,2013-10,33,2,31,-41.45454545454545
1714,Cluster 35,2013-11,24,3,21,-42.977272727272734
1715,Cluster 35,2013-12,33,1,32,-35.61363636363636
1716,Cluster 35,2014-01,24,3,21,-41.022727272727266
1717,Cluster 35,2014-02,22,0,22,-27.954545454545453
1718,Cluster 35,2014-03,22,2,20,-33.77272727272727
1719,Cluster 35,2014-04,33,1,32,-29.159090909090907
1720,Cluster 35,2014-05,21,1,20,-50.86363636363636
1721,Cluster 35,2014-06,32,4,28,-44.06818181818181
1722,Cluster 35,2014-07,23,1,22,-61.15909090909091
1723,Cluster 35,2014-08,27,3,24,-60.0
1724,Cluster 35,2014-09,33,3,30,-51.11363636363636
1725,Cluster 35,2014-10,48,5,43,-39.09090909090909
1726,Cluster 35,2014-11,33,0,33,-42.43181818181819
1727,Cluster 35,2014-12,33,1,32,-36.5
1728,Cluster 35,2015-01,34,2,32,-31.272727272727266
1729,Cluster 35,2015-02,17,1,16,-25.909090909090907
1730,Cluster 35,2015-03,11,2,9,-45.25
1731,Cluster 35,2015-04,28,0,28,-38.54545454545455
1732,Cluster 35,2015-05,32,2,30,-43.90909090909091
1733,Cluster 35,2015-06,25,5,20,-52.29545454545455
1734,Cluster 35,2015-07,36,0,36,-46.5
1735,Cluster 35,2015-08,36,1,35,-42.56818181818181
1736,Cluster 35,2015-09,20,2,18,-53.81818181818181
1737,Cluster 35,2015-10,30,2,28,-47.227272727272734
1738,Cluster 35,2015-11,31,2,29,-40.09090909090909
1739,Cluster 35,2015-12,36,3,33,-40.38636363636364
1740,Cluster 36,2011-01,18,2,16,-33.22727272727273
1741,Cluster 36,2011-02,26,8,18,-22.340909090909093
1742,Cluster 36,2011-03,30,9,21,-28.022727272727273
1743,Cluster 36,2011-04,31,4,27,-24.113636363636367
1744,Cluster 36,2011-05,27,4,23,-37.272727272727266
1745,Cluster 36,2011-06,36,9,27,-30.931818181818187
1746,Cluster 36,2011-07,53,7,46,-15.522727272727266
1747,Cluster 36,2011-08,30,7,23,-37.61363636363636
1748,Cluster 36,2011-09,34,3,31,-33.36363636363636
1749,Cluster 36,2011-10,35,4,31,-38.93181818181819
1750,Cluster 36,2011-11,36,5,31,-32.36363636363636
1751,Cluster 36,2011-12,27,5,22,-42.56818181818181
1752,Cluster 36,2012-01,40,5,35,-27.454545454545453
1753,Cluster 36,2012-02,26,2,24,-28.06818181818182
1754,Cluster 36,2012-03,27,6,21,-29.863636363636367
1755,Cluster 36,2012-04,40,6,34,-18.204545454545453
1756,Cluster 36,2012-05,42,4,38,-24.568181818181813
1757,Cluster 36,2012-06,38,8,30,-29.795454545454547
1758,Cluster 36,2012-07,35,4,31,-38.18181818181819
1759,Cluster 36,2012-08,44,8,36,-33.65909090909091
1760,Cluster 36,2012-09,31,8,23,-39.15909090909091
1761,Cluster 36,2012-10,51,7,44,-23.61363636363636
1762,Cluster 36,2012-11,56,7,49,-9.431818181818187
1763,Cluster 36,2012-12,43,4,39,-24.659090909090907
1764,Cluster 36,2013-01,32,4,28,-31.727272727272727
1765,Cluster 36,2013-02,22,6,16,-28.795454545454547
1766,Cluster 36,2013-03,43,6,37,-15.477272727272727
1767,Cluster 36,2013-04,33,6,27,-28.454545454545453
1768,Cluster 36,2013-05,35,6,29,-37.36363636363636
1769,Cluster 36,2013-06,44,10,34,-28.272727272727266
1770,Cluster 36,2013-07,40,6,34,-32.31818181818181
1771,Cluster 36,2013-08,50,11,39,-24.38636363636364
1772,Cluster 36,2013-09,37,6,31,-39.11363636363636
1773,Cluster 36,2013-10,36,4,32,-38.45454545454545
1774,Cluster 36,2013-11,37,6,31,-29.977272727272734
1775,Cluster 36,2013-12,31,6,25,-37.61363636363636
1776,Cluster 36,2014-01,25,3,22,-40.022727272727266
1777,Cluster 36,2014-02,24,1,23,-25.954545454545453
1778,Cluster 36,2014-03,34,10,24,-21.772727272727273
1779,Cluster 36,2014-04,28,8,20,-34.15909090909091
1780,Cluster 36,2014-05,37,10,27,-34.86363636363636
1781,Cluster 36,2014-06,47,13,34,-29.068181818181813
1782,Cluster 36,2014-07,41,8,33,-43.15909090909091
1783,Cluster 36,2014-08,38,8,30,-49.0
1784,Cluster 36,2014-09,31,5,26,-53.11363636363636
1785,Cluster 36,2014-10,45,8,37,-42.09090909090909
1786,Cluster 36,2014-11,30,8,22,-45.43181818181819
1787,Cluster 36,2014-12,23,3,20,-46.5
1788,Cluster 36,2015-01,34,6,28,-31.272727272727266
1789,Cluster 36,2015-02,26,10,16,-16.909090909090907
1790,Cluster 36,2015-03,23,4,19,-33.25
1791,Cluster 36,2015-04,40,12,28,-26.545454545454547
1792,Cluster 36,2015-05,37,9,28,-38.90909090909091
1793,Cluster 36,2015-06,30,4,26,-47.29545454545455
1794,Cluster 36,2015-07,39,10,29,-43.5
1795,Cluster 36,2015-08,20,0,20,-58.56818181818181
1796,Cluster 36,2015-09,28,3,25,-45.81818181818181
1797,Cluster 36,2015-10,38,10,28,-39.227272727272734
1798,Cluster 36,2015-11,16,4,12,-55.09090909090909
1799,Cluster 36,2015-12,32,5,27,-44.38636363636364
1800,Cluster 37,2011-01,45,8,37,-6.227272727272727
1801,Cluster 37,2011-02,45,5,40,-3.3409090909090935
1802,Cluster 37,2011-03,45,11,34,-13.022727272727273
1803,Cluster 37,2011-04,43,11,32,-12.113636363636367
1804,Cluster 37,2011-05,49,6,43,-15.272727272727266
1805,Cluster 37,2011-06,39,9,30,-27.931818181818187
1806,Cluster 37,2011-07,62,15,47,-6.522727272727266
1807,Cluster 37,2011-08,52,8,44,-15.61363636363636
1808,Cluster 37,2011-09,46,14,32,-21.36363636363636
1809,Cluster 37,2011-10,47,7,40,-26.931818181818187
1810,Cluster 37,2011-11,43,5,38,-25.36363636363636
1811,Cluster 37,2011-12,59,12,47,-10.568181818181813
1812,Cluster 37,2012-01,46,7,39,-21.454545454545453
1813,Cluster 37,2012-02,29,3,26,-25.06818181818182
1814,Cluster 37,2012-03,56,14,42,-0.8636363636363669
1815,Cluster 37,2012-04,38,7,31,-20.204545454545453
1816,Cluster 37,2012-05,77,15,62,10.431818181818187
1817,Cluster 37,2012-06,58,8,50,-9.795454545454547
1818,Cluster 37,2012-07,47,11,36,-26.181818181818187
1819,Cluster 37,2012-08,74,12,62,-3.6590909090909065
1820,Cluster 37,2012-09,40,8,32,-30.159090909090907
1821,Cluster 37,2012-10,45,7,38,-29.61363636363636
1822,Cluster 37,2012-11,50,10,40,-15.431818181818187
1823,Cluster 37,2012-12,49,6,43,-18.659090909090907
1824,Cluster 37,2013-01,38,7,31,-25.727272727272727
1825,Cluster 37,2013-02,29,5,24,-21.795454545454547
1826,Cluster 37,2013-03,41,9,32,-17.477272727272727
1827,Cluster 37,2013-04,50,13,37,-11.454545454545453
1828,Cluster 37,2013-05,49,11,38,-23.36363636363636
1829,Cluster 37,2013-06,56,12,44,-16.272727272727266
1830,Cluster 37,2013-07,57,6,51,-15.318181818181813
1831,Cluster 37,2013-08,37,4,33,-37.38636363636364
1832,Cluster 37,2013-09,48,9,39,-28.11363636363636
1833,Cluster 37,2013-10,40,9,31,-34.45454545454545
1834,Cluster 37,2013-11,38,6,32,-28.977272727272734
1835,Cluster 37,2013-12,44,9,35,-24.61363636363636
1836,Cluster 37,2014-01,37,9,28,-28.022727272727266
1837,Cluster 37,2014-02,23,7,16,-26.954545454545453
1838,Cluster 37,2014-03,21,8,13,-34.77272727272727
1839,Cluster 37,2014-04,33,8,25,-29.159090909090907
1840,Cluster 37,2014-05,29,7,22,-42.86363636363636
1841,Cluster 37,2014-06,47,10,37,-29.068181818181813
1842,Cluster 37,2014-07,40,4,36,-44.15909090909091
1843,Cluster 37,2014-08,48,9,39,-39.0
1844,Cluster 37,2014-09,37,7,30,-47.11363636363636
1845,Cluster 37,2014-10,48,8,40,-39.09090909090909
1846,Cluster 37,2014-11,48,7,41,-27.431818181818187
1847,Cluster 37,2014-12,30,6,24,-39.5
1848,Cluster 37,2015-01,40,9,31,-25.272727272727266
1849,Cluster 37,2015-02,25,6,19,-17.909090909090907
1850,Cluster 37,2015-03,44,3,41,-12.25
1851,Cluster 37,2015-04,38,5,33,-28.545454545454547
1852,Cluster 37,2015-05,54,10,44,-21.909090909090907
1853,Cluster 37,2015-06,44,5,39,-33.29545454545455
1854,Cluster 37,2015-07,44,12,32,-38.5
1855,Cluster 37,2015-08,61,13,48,-17.568181818181813
1856,Cluster 37,2015-09,42,8,34,-31.818181818181813
1857,Cluster 37,2015-10,45,6,39,-32.227272727272734
1858,Cluster 37,2015-11,46,8,38,-25.090909090909093
1859,Cluster 37,2015-12,49,9,40,-27.38636363636364
1860,Cluster 38,2011-01,63,12,51,11.772727272727273
1861,Cluster 38,2011-02,39,5,34,-9.340909090909093
1862,Cluster 38,2011-03,55,3,52,-3.0227272727272734
1863,Cluster 38,2011-04,52,10,42,-3.113636363636367
1864,Cluster 38,2011-05,64,7,57,-0.27272727272726627
1865,Cluster 38,2011-06,43,9,34,-23.931818181818187
1866,Cluster 38,2011-07,62,9,53,-6.522727272727266
1867,Cluster 38,2011-08,56,4,52,-11.61363636363636
1868,Cluster 38,2011-09,57,11,46,-10.36363636363636
1869,Cluster 38,2011-10,54,14,40,-19.931818181818187
1870,Cluster 38,2011-11,53,7,46,-15.36363636363636
1871,Cluster 38,2011-12,55,10,45,-14.568181818181813
1872,Cluster 38,2012-01,55,8,47,-12.454545454545453
1873,Cluster 38,2012-02,25,4,21,-29.06818181818182
1874,Cluster 38,2012-03,55,12,43,-1.8636363636363669
1875,Cluster 38,2012-04,63,12,51,4.795454545454547
1876,Cluster 38,2012-05,62,10,52,-4.568181818181813
1877,Cluster 38,2012-06,72,17,55,4.204545454545453
1878,Cluster 38,2012-07,72,10,62,-1.181818181818187
1879,Cluster 38,2012-08,66,12,54,-11.659090909090907
1880,Cluster 38,2012-09,50,10,40,-20.159090909090907
1881,Cluster 38,2012-10,63,10,53,-11.61363636363636
1882,Cluster 38,2012-11,57,1,56,-8.431818181818187
1883,Cluster 38,2012-12,61,12,49,-6.6590909090909065
1884,Cluster 38,2013-01,48,7,41,-15.727272727272727
1885,Cluster 38,2013-02,46,9,37,-4.795454545454547
1886,Cluster 38,2013-03,47,11,36,-11.477272727272727
1887,Cluster 38,2013-04,59,13,46,-2.4545454545454533
1888,Cluster 38,2013-05,53,8,45,-19.36363636363636
1889,Cluster 38,2013-06,60,11,49,-12.272727272727266
1890,Cluster 38,2013-07,69,14,55,-3.318181818181813
1891,Cluster 38,2013-08,75,9,66,0.6136363636363598
1892,Cluster 38,2013-09,82,16,66,5.88636363636364
1893,Cluster 38,2013-10,57,13,44,-17.454545454545453
1894,Cluster 38,2013-11,73,7,66,6.022727272727266
1895,Cluster 38,2013-12,60,10,50,-8.61363636363636
1896,Cluster 38,2014-01,41,10,31,-24.022727272727266
1897,Cluster 38,2014-02,37,12,25,-12.954545454545453
1898,Cluster 38,2014-03,43,17,26,-12.772727272727273
1899,Cluster 38,2014-04,53,12,41,-9.159090909090907
1900,Cluster 38,2014-05,43,5,38,-28.86363636363636
1901,Cluster 38,2014-06,65,8,57,-11.068181818181813
1902,Cluster 38,2014-07,61,12,49,-23.159090909090907
1903,Cluster 38,2014-08,75,14,61,-12.0
1904,Cluster 38,2014-09,62,11,51,-22.11363636363636
1905,Cluster 38,2014-10,83,10,73,-4.0909090909090935
1906,Cluster 38,2014-11,56,12,44,-19.431818181818187
1907,Cluster 38,2014-12,59,10,49,-10.5
1908,Cluster 38,2015-01,55,14,41,-10.272727272727266
1909,Cluster 38,2015-02,25,4,21,-17.909090909090907
1910,Cluster 38,2015-03,40,5,35,-16.25
1911,Cluster 38,2015-04,57,8,49,-9.545454545454547
1912,Cluster 38,2015-05,68,13,55,-7.9090909090909065
1913,Cluster 38,2015-06,66,9,57,-11.295454545454547
1914,Cluster 38,2015-07,80,12,68,-2.5
1915,Cluster 38,2015-08,63,15,48,-15.568181818181813
1916,Cluster 38,2015-09,63,8,55,-10.818181818181813
1917,Cluster 38,2015-10,61,14,47,-16.227272727272734
1918,Cluster 38,2015-11,69,11,58,-2.0909090909090935
1919,Cluster 38,2015-12,63,15,48,-13.38636363636364
1920,Cluster 39,2011-01,134,11,123,82.77272727272728
1921,Cluster 39,2011-02,103,9,94,54.65909090909091
1922,Cluster 39,2011-03,133,21,112,74.97727272727272
1923,Cluster 39,2011-04,140,23,117,84.88636363636363
1924,Cluster 39,2011-05,160,19,141,95.72727272727273
1925,Cluster 39,2011-06,137,24,113,70.06818181818181
1926,Cluster 39,2011-07,154,28,126,85.47727272727273
1927,Cluster 39,2011-08,162,19,143,94.38636363636364
1928,Cluster 39,2011-09,159,33,126,91.63636363636364
1929,Cluster 39,2011-10,174,24,150,100.06818181818181
1930,Cluster 39,2011-11,152,15,137,83.63636363636364
1931,Cluster 39,2011-12,152,28,124,82.43181818181819
1932,Cluster 39,2012-01,149,16,133,81.54545454545455
1933,Cluster 39,2012-02,115,16,99,60.93181818181818
1934,Cluster 39,2012-03,109,24,85,52.13636363636363
1935,Cluster 39,2012-04,116,25,91,57.79545454545455
1936,Cluster 39,2012-05,130,18,112,63.43181818181819
1937,Cluster 39,2012-06,102,17,85,34.20454545454545
1938,Cluster 39,2012-07,134,28,106,60.81818181818181
1939,Cluster 39,2012-08,153,33,120,75.3409090909091
1940,Cluster 39,2012-09,129,30,99,58.84090909090909
1941,Cluster 39,2012-10,148,34,114,73.38636363636364
1942,Cluster 39,2012-11,168,19,149,102.56818181818181
1943,Cluster 39,2012-12,144,26,118,76.3409090909091
1944,Cluster 39,2013-01,111,15,96,47.27272727272727
1945,Cluster 39,2013-02,88,20,68,37.20454545454545
1946,Cluster 39,2013-03,93,24,69,34.52272727272727
1947,Cluster 39,2013-04,116,22,94,54.54545454545455
1948,Cluster 39,2013-05,129,31,98,56.63636363636364
1949,Cluster 39,2013-06,159,25,134,86.72727272727273
1950,Cluster 39,2013-07,173,27,146,100.68181818181819
1951,Cluster 39,2013-08,158,23,135,83.61363636363636
1952,Cluster 39,2013-09,181,25,156,104.88636363636364
1953,Cluster 39,2013-10,176,27,149,101.54545454545455
1954,Cluster 39,2013-11,153,21,132,86.02272727272727
1955,Cluster 39,2013-12,123,19,104,54.38636363636364
1956,Cluster 39,2014-01,107,18,89,41.977272727272734
1957,Cluster 39,2014-02,71,8,63,21.045454545454547
1958,Cluster 39,2014-03,101,20,81,45.22727272727273
1959,Cluster 39,2014-04,109,20,89,46.84090909090909
1960,Cluster 39,2014-05,118,27,91,46.13636363636364
1961,Cluster 39,2014-06,131,25,106,54.93181818181819
1962,Cluster 39,2014-07,133,27,106,48.84090909090909
1963,Cluster 39,2014-08,134,23,111,47.0
1964,Cluster 39,2014-09,153,19,134,68.88636363636364
1965,Cluster 39,2014-10,139,23,116,51.90909090909091
1966,Cluster 39,2014-11,138,35,103,62.56818181818181
1967,Cluster 39,2014-12,139,29,110,69.5
1968,Cluster 39,2015-01,100,17,83,34.727272727272734
1969,Cluster 39,2015-02,58,11,47,15.090909090909093
1970,Cluster 39,2015-03,87,23,64,30.75
1971,Cluster 39,2015-04,109,16,93,42.45454545454545
1972,Cluster 39,2015-05,124,25,99,48.09090909090909
1973,Cluster 39,2015-06,144,25,119,66.70454545454545
1974,Cluster 39,2015-07,126,15,111,43.5
1975,Cluster 39,2015-08,144,23,121,65.43181818181819
1976,Cluster 39,2015-09,144,33,111,70.18181818181819
1977,Cluster 39,2015-10,128,25,103,50.772727272727266
1978,Cluster 39,2015-11,135,26,109,63.90909090909091
1979,Cluster 39,2015-12,118,24,94,41.61363636363636
1980,Cluster 4,2011-01,59,1,58,7.772727272727273
1981,Cluster 4,2011-02,66,0,66,17.659090909090907
1982,Cluster 4,2011-03,88,1,87,29.977272727272727
1983,Cluster 4,2011-04,73,1,72,17.886363636363633
1984,Cluster 4,2011-05,94,4,90,29.727272727272734
1985,Cluster 4,2011-06,77,1,76,10.068181818181813
1986,Cluster 4,2011-07,84,1,83,15.477272727272734
1987,Cluster 4,2011-08,79,1,78,11.38636363636364
1988,Cluster 4,2011-09,91,1,90,23.63636363636364
1989,Cluster 4,2011-10,80,0,80,6.068181818181813
1990,Cluster 4,2011-11,72,3,69,3.6363636363636402
1991,Cluster 4,2011-12,87,2,85,17.431818181818187
1992,Cluster 4,2012-01,87,2,85,19.545454545454547
1993,Cluster 4,2012-02,59,0,59,4.93181818181818
1994,Cluster 4,2012-03,77,1,76,20.136363636363633
1995,Cluster 4,2012-04,60,0,60,1.7954545454545467
1996,Cluster 4,2012-05,98,0,98,31.431818181818187
1997,Cluster 4,2012-06,67,0,67,-0.7954545454545467
1998,Cluster 4,2012-07,75,0,75,1.818181818181813
1999,Cluster 4,2012-08,98,2,96,20.340909090909093
2000,Cluster 4,2012-09,75,1,74,4.8409090909090935
2001,Cluster 4,2012-10,97,2,95,22.38636363636364
2002,Cluster 4,2012-11,77,4,73,11.568181818181813
2003,Cluster 4,2012-12,64,1,63,-3.6590909090909065
2004,Cluster 4,2013-01,68,0,68,4.272727272727273
2005,Cluster 4,2013-02,44,1,43,-6.795454545454547
2006,Cluster 4,2013-03,64,1,63,5.522727272727273
2007,Cluster 4,2013-04,89,2,87,27.545454545454547
2008,Cluster 4,2013-05,92,4,88,19.63636363636364
2009,Cluster 4,2013-06,90,2,88,17.727272727272734
2010,Cluster 4,2013-07,99,0,99,26.681818181818187
2011,Cluster 4,2013-08,100,2,98,25.61363636363636
2012,Cluster 4,2013-09,103,1,102,26.88636363636364
2013,Cluster 4,2013-10,71,4,67,-3.4545454545454533
2014,Cluster 4,2013-11,57,1,56,-9.977272727272734
2015,Cluster 4,2013-12,76,3,73,7.38636363636364
2016,Cluster 4,2014-01,77,2,75,11.977272727272734
2017,Cluster 4,2014-02,62,5,57,12.045454545454547
2018,Cluster 4,2014-03,57,4,53,1.2272727272727266
2019,Cluster 4,2014-04,74,2,72,11.840909090909093
2020,Cluster 4,2014-05,117,3,114,45.13636363636364
2021,Cluster 4,2014-06,103,1,102,26.931818181818187
2022,Cluster 4,2014-07,111,1,110,26.840909090909093
2023,Cluster 4,2014-08,98,0,98,11.0
2024,Cluster 4,2014-09,80,1,79,-4.11363636363636
2025,Cluster 4,2014-10,83,2,81,-4.0909090909090935
2026,Cluster 4,2014-11,106,1,105,30.568181818181813
2027,Cluster 4,2014-12,91,1,90,21.5
2028,Cluster 4,2015-01,100,5,95,34.727272727272734
2029,Cluster 4,2015-02,58,4,54,15.090909090909093
2030,Cluster 4,2015-03,65,2,63,8.75
2031,Cluster 4,2015-04,87,0,87,20.454545454545453
2032,Cluster 4,2015-05,65,2,63,-10.909090909090907
2033,Cluster 4,2015-06,85,1,84,7.704545454545453
2034,Cluster 4,2015-07,96,2,94,13.5
2035,Cluster 4,2015-08,106,1,105,27.431818181818187
2036,Cluster 4,2015-09,99,1,98,25.181818181818187
2037,Cluster 4,2015-10,100,1,99,22.772727272727266
2038,Cluster 4,2015-11,117,2,115,45.90909090909091
2039,Cluster 4,2015-12,85,3,82,8.61363636363636
2040,Cluster 40,2011-01,1,0,1,-50.22727272727273
2041,Cluster 40,2011-02,3,0,3,-45.34090909090909
2042,Cluster 40,2011-03,1,0,1,-57.02272727272727
2043,Cluster 40,2011-04,2,0,2,-53.11363636363637
2044,Cluster 40,2011-05,1,0,1,-63.272727272727266
2045,Cluster 40,2011-06,1,0,1,-65.93181818181819
2046,Cluster 40,2011-07,3,2,1,-65.52272727272727
2047,Cluster 40,2011-08,4,0,4,-63.61363636363636
2048,Cluster 40,2011-09,2,1,1,-65.36363636363636
2049,Cluster 40,2011-10,3,1,2,-70.93181818181819
2050,Cluster 40,2011-11,1,0,1,-67.36363636363636
2051,Cluster 40,2011-12,2,0,2,-67.56818181818181
2052,Cluster 40,2012-01,1,0,1,-66.45454545454545
2053,Cluster 40,2012-02,0,0,0,-54.06818181818182
2054,Cluster 40,2012-03,2,2,0,-54.86363636363637
2055,Cluster 40,2012-04,1,0,1,-57.20454545454545
2056,Cluster 40,2012-05,4,1,3,-62.56818181818181
2057,Cluster 40,2012-06,3,2,1,-64.79545454545455
2058,Cluster 40,2012-07,1,0,1,-72.18181818181819
2059,Cluster 40,2012-08,3,0,3,-74.6590909090909
2060,Cluster 40,2012-09,1,0,1,-69.1590909090909
2061,Cluster 40,2012-10,2,1,1,-72.61363636363636
2062,Cluster 40,2012-11,1,0,1,-64.43181818181819
2063,Cluster 40,2012-12,0,0,0,-67.6590909090909
2064,Cluster 40,2013-01,3,1,2,-60.72727272727273
2065,Cluster 40,2013-02,0,0,0,-50.79545454545455
2066,Cluster 40,2013-03,1,0,1,-57.47727272727273
2067,Cluster 40,2013-04,1,0,1,-60.45454545454545
2068,Cluster 40,2013-05,3,1,2,-69.36363636363636
2069,Cluster 40,2013-06,0,0,0,-72.27272727272727
2070,Cluster 40,2013-07,1,0,1,-71.31818181818181
2071,Cluster 40,2013-08,3,3,0,-71.38636363636364
2072,Cluster 40,2013-09,2,0,2,-74.11363636363636
2073,Cluster 40,2013-10,4,1,3,-70.45454545454545
2074,Cluster 40,2013-11,1,0,1,-65.97727272727273
2075,Cluster 40,2013-12,3,0,3,-65.61363636363636
2076,Cluster 40,2014-01,0,0,0,-65.02272727272727
2077,Cluster 40,2014-02,1,0,1,-48.95454545454545
2078,Cluster 40,2014-03,3,1,2,-52.77272727272727
2079,Cluster 40,2014-04,1,0,1,-61.15909090909091
2080,Cluster 40,2014-05,3,0,3,-68.86363636363636
2081,Cluster 40,2014-06,1,0,1,-75.06818181818181
2082,Cluster 40,2014-07,2,0,2,-82.1590909090909
2083,Cluster 40,2014-08,3,0,3,-84.0
2084,Cluster 40,2014-09,6,0,6,-78.11363636363636
2085,Cluster 40,2014-10,2,0,2,-85.0909090909091
2086,Cluster 40,2014-11,1,0,1,-74.43181818181819
2087,Cluster 40,2014-12,1,0,1,-68.5
2088,Cluster 40,2015-01,1,0,1,-64.27272727272727
2089,Cluster 40,2015-02,4,0,4,-38.90909090909091
2090,Cluster 40,2015-03,1,1,0,-55.25
2091,Cluster 40,2015-04,1,0,1,-65.54545454545455
2092,Cluster 40,2015-05,0,0,0,-75.9090909090909
2093,Cluster 40,2015-06,1,0,1,-76.29545454545455
2094,Cluster 40,2015-07,3,0,3,-79.5
2095,Cluster 40,2015-08,3,0,3,-75.56818181818181
2096,Cluster 40,2015-09,1,0,1,-72.81818181818181
2097,Cluster 40,2015-10,1,0,1,-76.22727272727273
2098,Cluster 40,2015-11,3,0,3,-68.0909090909091
2099,Cluster 40,2015-12,3,0,3,-73.38636363636364
2100,Cluster 41,2011-01,2,0,2,-49.22727272727273
2101,Cluster 41,2011-02,2,0,2,-46.34090909090909
2102,Cluster 41,2011-03,0,0,0,-58.02272727272727
2103,Cluster 41,2011-04,2,0,2,-53.11363636363637
2104,Cluster 41,2011-05,0,0,0,-64.27272727272727
2105,Cluster 41,2011-06,0,0,0,-66.93181818181819
2106,Cluster 41,2011-07,2,0,2,-66.52272727272727
2107,Cluster 41,2011-08,1,0,1,-66.61363636363636
2108,Cluster 41,2011-09,2,0,2,-65.36363636363636
2109,Cluster 41,2011-10,5,0,5,-68.93181818181819
2110,Cluster 41,2011-11,2,0,2,-66.36363636363636
2111,Cluster 41,2011-12,0,0,0,-69.56818181818181
2112,Cluster 41,2012-01,2,0,2,-65.45454545454545
2113,Cluster 41,2012-02,1,0,1,-53.06818181818182
2114,Cluster 41,2012-03,1,0,1,-55.86363636363637
2115,Cluster 41,2012-04,1,0,1,-57.20454545454545
2116,Cluster 41,2012-05,2,0,2,-64.56818181818181
2117,Cluster 41,2012-06,0,0,0,-67.79545454545455
2118,Cluster 41,2012-07,1,0,1,-72.18181818181819
2119,Cluster 41,2012-08,0,0,0,-77.6590909090909
2120,Cluster 41,2012-09,3,0,3,-67.1590909090909
2121,Cluster 41,2012-10,2,0,2,-72.61363636363636
2122,Cluster 41,2012-11,1,0,1,-64.43181818181819
2123,Cluster 41,2012-12,0,0,0,-67.6590909090909
2124,Cluster 41,2013-01,0,0,0,-63.72727272727273
2125,Cluster 41,2013-02,0,0,0,-50.79545454545455
2126,Cluster 41,2013-03,0,0,0,-58.47727272727273
2127,Cluster 41,2013-04,0,0,0,-61.45454545454545
2128,Cluster 41,2013-05,1,0,1,-71.36363636363636
2129,Cluster 41,2013-06,1,0,1,-71.27272727272727
2130,Cluster 41,2013-07,1,0,1,-71.31818181818181
2131,Cluster 41,2013-08,0,0,0,-74.38636363636364
2132,Cluster 41,2013-09,1,1,0,-75.11363636363636
2133,Cluster 41,2013-10,0,0,0,-74.45454545454545
2134,Cluster 41,2013-11,0,0,0,-66.97727272727273
2135,Cluster 41,2013-12,1,0,1,-67.61363636363636
2136,Cluster 41,2014-01,0,0,0,-65.02272727272727
2137,Cluster 41,2014-02,0,0,0,-49.95454545454545
2138,Cluster 41,2014-03,2,0,2,-53.77272727272727
2139,Cluster 41,2014-04,1,0,1,-61.15909090909091
2140,Cluster 41,2014-05,1,0,1,-70.86363636363636
2141,Cluster 41,2014-06,1,0,1,-75.06818181818181
2142,Cluster 41,2014-07,2,0,2,-82.1590909090909
2143,Cluster 41,2014-08,1,0,1,-86.0
2144,Cluster 41,2014-09,1,0,1,-83.11363636363636
2145,Cluster 41,2014-10,1,0,1,-86.0909090909091
2146,Cluster 41,2014-11,0,0,0,-75.43181818181819
2147,Cluster 41,2014-12,2,0,2,-67.5
2148,Cluster 41,2015-01,0,0,0,-65.27272727272727
2149,Cluster 41,2015-02,0,0,0,-42.90909090909091
2150,Cluster 41,2015-03,0,0,0,-56.25
2151,Cluster 41,2015-04,0,0,0,-66.54545454545455
2152,Cluster 41,2015-05,2,0,2,-73.9090909090909
2153,Cluster 41,2015-06,0,0,0,-77.29545454545455
2154,Cluster 41,2015-07,1,0,1,-81.5
2155,Cluster 41,2015-08,1,0,1,-77.56818181818181
2156,Cluster 41,2015-09,0,0,0,-73.81818181818181
2157,Cluster 41,2015-10,0,0,0,-77.22727272727273
2158,Cluster 41,2015-11,0,0,0,-71.0909090909091
2159,Cluster 41,2015-12,0,0,0,-76.38636363636364
2160,Cluster 42,2011-01,0,0,0,-51.22727272727273
2161,Cluster 42,2011-02,0,0,0,-48.34090909090909
2162,Cluster 42,2011-03,0,0,0,-58.02272727272727
2163,Cluster 42,2011-04,0,0,0,-55.11363636363637
2164,Cluster 42,2011-05,0,0,0,-64.27272727272727
2165,Cluster 42,2011-06,1,0,1,-65.93181818181819
2166,Cluster 42,2011-07,0,0,0,-68.52272727272727
2167,Cluster 42,2011-08,0,0,0,-67.61363636363636
2168,Cluster 42,2011-09,0,0,0,-67.36363636363636
2169,Cluster 42,2011-10,0,0,0,-73.93181818181819
2170,Cluster 42,2011-11,0,0,0,-68.36363636363636
2171,Cluster 42,2011-12,0,0,0,-69.56818181818181
2172,Cluster 42,2012-01,0,0,0,-67.45454545454545
2173,Cluster 42,2012-02,0,0,0,-54.06818181818182
2174,Cluster 42,2012-03,0,0,0,-56.86363636363637
2175,Cluster 42,2012-04,0,0,0,-58.20454545454545
2176,Cluster 42,2012-05,1,0,1,-65.56818181818181
2177,Cluster 42,2012-06,0,0,0,-67.79545454545455
2178,Cluster 42,2012-07,0,0,0,-73.18181818181819
2179,Cluster 42,2012-08,0,0,0,-77.6590909090909
2180,Cluster 42,2012-09,0,0,0,-70.1590909090909
2181,Cluster 42,2012-10,0,0,0,-74.61363636363636
2182,Cluster 42,2012-11,0,0,0,-65.43181818181819
2183,Cluster 42,2012-12,0,0,0,-67.6590909090909
2184,Cluster 42,2013-01,0,0,0,-63.72727272727273
2185,Cluster 42,2013-02,0,0,0,-50.79545454545455
2186,Cluster 42,2013-03,0,0,0,-58.47727272727273
2187,Cluster 42,2013-04,0,0,0,-61.45454545454545
2188,Cluster 42,2013-05,0,0,0,-72.36363636363636
2189,Cluster 42,2013-06,0,0,0,-72.27272727272727
2190,Cluster 42,2013-07,0,0,0,-72.31818181818181
2191,Cluster 42,2013-08,0,0,0,-74.38636363636364
2192,Cluster 42,2013-09,0,0,0,-76.11363636363636
2193,Cluster 42,2013-10,0,0,0,-74.45454545454545
2194,Cluster 42,2013-11,0,0,0,-66.97727272727273
2195,Cluster 42,2013-12,0,0,0,-68.61363636363636
2196,Cluster 42,2014-01,0,0,0,-65.02272727272727
2197,Cluster 42,2014-02,0,0,0,-49.95454545454545
2198,Cluster 42,2014-03,0,0,0,-55.77272727272727
2199,Cluster 42,2014-04,0,0,0,-62.15909090909091
2200,Cluster 42,2014-05,0,0,0,-71.86363636363636
2201,Cluster 42,2014-06,0,0,0,-76.06818181818181
2202,Cluster 42,2014-07,0,0,0,-84.1590909090909
2203,Cluster 42,2014-08,0,0,0,-87.0
2204,Cluster 42,2014-09,0,0,0,-84.11363636363636
2205,Cluster 42,2014-10,0,0,0,-87.0909090909091
2206,Cluster 42,2014-11,1,0,1,-74.43181818181819
2207,Cluster 42,2014-12,0,0,0,-69.5
2208,Cluster 42,2015-01,0,0,0,-65.27272727272727
2209,Cluster 42,2015-02,0,0,0,-42.90909090909091
2210,Cluster 42,2015-03,0,0,0,-56.25
2211,Cluster 42,2015-04,0,0,0,-66.54545454545455
2212,Cluster 42,2015-05,0,0,0,-75.9090909090909
2213,Cluster 42,2015-06,0,0,0,-77.29545454545455
2214,Cluster 42,2015-07,0,0,0,-82.5
2215,Cluster 42,2015-08,0,0,0,-78.56818181818181
2216,Cluster 42,2015-09,0,0,0,-73.81818181818181
2217,Cluster 42,2015-10,0,0,0,-77.22727272727273
2218,Cluster 42,2015-11,0,0,0,-71.0909090909091
2219,Cluster 42,2015-12,0,0,0,-76.38636363636364
2220,Cluster 43,2011-01,3,0,3,-48.22727272727273
2221,Cluster 43,2011-02,6,1,5,-42.34090909090909
2222,Cluster 43,2011-03,3,0,3,-55.02272727272727
2223,Cluster 43,2011-04,4,0,4,-51.11363636363637
2224,Cluster 43,2011-05,10,0,10,-54.272727272727266
2225,Cluster 43,2011-06,4,0,4,-62.93181818181819
2226,Cluster 43,2011-07,4,1,3,-64.52272727272727
2227,Cluster 43,2011-08,1,0,1,-66.61363636363636
2228,Cluster 43,2011-09,4,0,4,-63.36363636363636
2229,Cluster 43,2011-10,7,1,6,-66.93181818181819
2230,Cluster 43,2011-11,6,1,5,-62.36363636363636
2231,Cluster 43,2011-12,5,1,4,-64.56818181818181
2232,Cluster 43,2012-01,7,0,7,-60.45454545454545
2233,Cluster 43,2012-02,2,0,2,-52.06818181818182
2234,Cluster 43,2012-03,5,0,5,-51.86363636363637
2235,Cluster 43,2012-04,4,2,2,-54.20454545454545
2236,Cluster 43,2012-05,4,1,3,-62.56818181818181
2237,Cluster 43,2012-06,0,0,0,-67.79545454545455
2238,Cluster 43,2012-07,0,0,0,-73.18181818181819
2239,Cluster 43,2012-08,7,2,5,-70.6590909090909
2240,Cluster 43,2012-09,0,0,0,-70.1590909090909
2241,Cluster 43,2012-10,6,1,5,-68.61363636363636
2242,Cluster 43,2012-11,3,0,3,-62.43181818181819
2243,Cluster 43,2012-12,5,1,4,-62.65909090909091
2244,Cluster 43,2013-01,3,2,1,-60.72727272727273
2245,Cluster 43,2013-02,2,1,1,-48.79545454545455
2246,Cluster 43,2013-03,3,1,2,-55.47727272727273
2247,Cluster 43,2013-04,6,1,5,-55.45454545454545
2248,Cluster 43,2013-05,4,0,4,-68.36363636363636
2249,Cluster 43,2013-06,5,1,4,-67.27272727272727
2250,Cluster 43,2013-07,6,1,5,-66.31818181818181
2251,Cluster 43,2013-08,5,0,5,-69.38636363636364
2252,Cluster 43,2013-09,5,0,5,-71.11363636363636
2253,Cluster 43,2013-10,8,0,8,-66.45454545454545
2254,Cluster 43,2013-11,7,0,7,-59.977272727272734
2255,Cluster 43,2013-12,7,1,6,-61.61363636363636
2256,Cluster 43,2014-01,5,1,4,-60.022727272727266
2257,Cluster 43,2014-02,3,0,3,-46.95454545454545
2258,Cluster 43,2014-03,7,1,6,-48.77272727272727
2259,Cluster 43,2014-04,6,0,6,-56.15909090909091
2260,Cluster 43,2014-05,3,0,3,-68.86363636363636
2261,Cluster 43,2014-06,2,0,2,-74.06818181818181
2262,Cluster 43,2014-07,4,0,4,-80.1590909090909
2263,Cluster 43,2014-08,6,1,5,-81.0
2264,Cluster 43,2014-09,5,0,5,-79.11363636363636
2265,Cluster 43,2014-10,9,0,9,-78.0909090909091
2266,Cluster 43,2014-11,1,1,0,-74.43181818181819
2267,Cluster 43,2014-12,5,0,5,-64.5
2268,Cluster 43,2015-01,7,1,6,-58.272727272727266
2269,Cluster 43,2015-02,0,0,0,-42.90909090909091
2270,Cluster 43,2015-03,3,1,2,-53.25
2271,Cluster 43,2015-04,7,2,5,-59.54545454545455
2272,Cluster 43,2015-05,3,0,3,-72.9090909090909
2273,Cluster 43,2015-06,6,2,4,-71.29545454545455
2274,Cluster 43,2015-07,4,1,3,-78.5
2275,Cluster 43,2015-08,3,0,3,-75.56818181818181
2276,Cluster 43,2015-09,8,3,5,-65.81818181818181
2277,Cluster 43,2015-10,12,5,7,-65.22727272727273
2278,Cluster 43,2015-11,7,1,6,-64.0909090909091
2279,Cluster 43,2015-12,7,4,3,-69.38636363636364
2280,Cluster 44,2011-01,10,0,10,-41.22727272727273
2281,Cluster 44,2011-02,8,0,8,-40.34090909090909
2282,Cluster 44,2011-03,6,1,5,-52.02272727272727
2283,Cluster 44,2011-04,12,1,11,-43.11363636363637
2284,Cluster 44,2011-05,16,2,14,-48.272727272727266
2285,Cluster 44,2011-06,16,1,15,-50.93181818181819
2286,Cluster 44,2011-07,12,1,11,-56.522727272727266
2287,Cluster 44,2011-08,22,0,22,-45.61363636363636
2288,Cluster 44,2011-09,13,0,13,-54.36363636363636
2289,Cluster 44,2011-10,7,1,6,-66.93181818181819
2290,Cluster 44,2011-11,12,1,11,-56.36363636363636
2291,Cluster 44,2011-12,7,1,6,-62.56818181818181
2292,Cluster 44,2012-01,8,1,7,-59.45454545454545
2293,Cluster 44,2012-02,8,0,8,-46.06818181818182
2294,Cluster 44,2012-03,7,1,6,-49.86363636363637
2295,Cluster 44,2012-04,6,2,4,-52.20454545454545
2296,Cluster 44,2012-05,8,3,5,-58.56818181818181
2297,Cluster 44,2012-06,15,0,15,-52.79545454545455
2298,Cluster 44,2012-07,11,2,9,-62.18181818181819
2299,Cluster 44,2012-08,10,0,10,-67.6590909090909
2300,Cluster 44,2012-09,11,2,9,-59.15909090909091
2301,Cluster 44,2012-10,14,0,14,-60.61363636363636
2302,Cluster 44,2012-11,10,0,10,-55.43181818181819
2303,Cluster 44,2012-12,8,2,6,-59.65909090909091
2304,Cluster 44,2013-01,8,2,6,-55.72727272727273
2305,Cluster 44,2013-02,15,1,14,-35.79545454545455
2306,Cluster 44,2013-03,1,0,1,-57.47727272727273
2307,Cluster 44,2013-04,9,2,7,-52.45454545454545
2308,Cluster 44,2013-05,10,0,10,-62.36363636363636
2309,Cluster 44,2013-06,9,2,7,-63.272727272727266
2310,Cluster 44,2013-07,9,2,7,-63.31818181818181
2311,Cluster 44,2013-08,12,3,9,-62.38636363636364
2312,Cluster 44,2013-09,8,1,7,-68.11363636363636
2313,Cluster 44,2013-10,12,2,10,-62.45454545454545
2314,Cluster 44,2013-11,11,1,10,-55.977272727272734
2315,Cluster 44,2013-12,4,0,4,-64.61363636363636
2316,Cluster 44,2014-01,6,4,2,-59.022727272727266
2317,Cluster 44,2014-02,6,1,5,-43.95454545454545
2318,Cluster 44,2014-03,5,0,5,-50.77272727272727
2319,Cluster 44,2014-04,4,2,2,-58.15909090909091
2320,Cluster 44,2014-05,9,2,7,-62.86363636363636
2321,Cluster 44,2014-06,10,2,8,-66.06818181818181
2322,Cluster 44,2014-07,14,0,14,-70.1590909090909
2323,Cluster 44,2014-08,12,1,11,-75.0
2324,Cluster 44,2014-09,9,2,7,-75.11363636363636
2325,Cluster 44,2014-10,16,2,14,-71.0909090909091
2326,Cluster 44,2014-11,3,0,3,-72.43181818181819
2327,Cluster 44,2014-12,8,0,8,-61.5
2328,Cluster 44,2015-01,4,0,4,-61.272727272727266
2329,Cluster 44,2015-02,6,2,4,-36.90909090909091
2330,Cluster 44,2015-03,4,1,3,-52.25
2331,Cluster 44,2015-04,9,3,6,-57.54545454545455
2332,Cluster 44,2015-05,6,1,5,-69.9090909090909
2333,Cluster 44,2015-06,7,1,6,-70.29545454545455
2334,Cluster 44,2015-07,13,1,12,-69.5
2335,Cluster 44,2015-08,10,3,7,-68.56818181818181
2336,Cluster 44,2015-09,7,0,7,-66.81818181818181
2337,Cluster 44,2015-10,2,1,1,-75.22727272727273
2338,Cluster 44,2015-11,8,1,7,-63.09090909090909
2339,Cluster 44,2015-12,10,3,7,-66.38636363636364
2340,Cluster 5,2011-01,42,1,41,-9.227272727272727
2341,Cluster 5,2011-02,28,2,26,-20.340909090909093
2342,Cluster 5,2011-03,53,1,52,-5.022727272727273
2343,Cluster 5,2011-04,41,1,40,-14.113636363636367
2344,Cluster 5,2011-05,51,0,51,-13.272727272727266
2345,Cluster 5,2011-06,65,2,63,-1.931818181818187
2346,Cluster 5,2011-07,41,1,40,-27.522727272727266
2347,Cluster 5,2011-08,46,1,45,-21.61363636363636
2348,Cluster 5,2011-09,40,2,38,-27.36363636363636
2349,Cluster 5,2011-10,50,4,46,-23.931818181818187
2350,Cluster 5,2011-11,51,0,51,-17.36363636363636
2351,Cluster 5,2011-12,48,3,45,-21.568181818181813
2352,Cluster 5,2012-01,26,1,25,-41.45454545454545
2353,Cluster 5,2012-02,36,1,35,-18.06818181818182
2354,Cluster 5,2012-03,45,1,44,-11.863636363636367
2355,Cluster 5,2012-04,34,1,33,-24.204545454545453
2356,Cluster 5,2012-05,39,2,37,-27.568181818181813
2357,Cluster 5,2012-06,52,4,48,-15.795454545454547
2358,Cluster 5,2012-07,48,3,45,-25.181818181818187
2359,Cluster 5,2012-08,55,1,54,-22.659090909090907
2360,Cluster 5,2012-09,39,2,37,-31.159090909090907
2361,Cluster 5,2012-10,61,3,58,-13.61363636363636
2362,Cluster 5,2012-11,35,0,35,-30.431818181818187
2363,Cluster 5,2012-12,40,1,39,-27.659090909090907
2364,Cluster 5,2013-01,47,0,47,-16.727272727272727
2365,Cluster 5,2013-02,29,2,27,-21.795454545454547
2366,Cluster 5,2013-03,34,1,33,-24.477272727272727
2367,Cluster 5,2013-04,35,0,35,-26.454545454545453
2368,Cluster 5,2013-05,35,0,35,-37.36363636363636
2369,Cluster 5,2013-06,53,3,50,-19.272727272727266
2370,Cluster 5,2013-07,47,2,45,-25.318181818181813
2371,Cluster 5,2013-08,50,1,49,-24.38636363636364
2372,Cluster 5,2013-09,54,1,53,-22.11363636363636
2373,Cluster 5,2013-10,41,0,41,-33.45454545454545
2374,Cluster 5,2013-11,36,0,36,-30.977272727272734
2375,Cluster 5,2013-12,45,2,43,-23.61363636363636
2376,Cluster 5,2014-01,35,1,34,-30.022727272727266
2377,Cluster 5,2014-02,39,1,38,-10.954545454545453
2378,Cluster 5,2014-03,39,0,39,-16.772727272727273
2379,Cluster 5,2014-04,35,3,32,-27.159090909090907
2380,Cluster 5,2014-05,58,2,56,-13.86363636363636
2381,Cluster 5,2014-06,54,0,54,-22.068181818181813
2382,Cluster 5,2014-07,58,2,56,-26.159090909090907
2383,Cluster 5,2014-08,67,0,67,-20.0
2384,Cluster 5,2014-09,70,0,70,-14.11363636363636
2385,Cluster 5,2014-10,63,2,61,-24.090909090909093
2386,Cluster 5,2014-11,56,3,53,-19.431818181818187
2387,Cluster 5,2014-12,53,1,52,-16.5
2388,Cluster 5,2015-01,34,2,32,-31.272727272727266
2389,Cluster 5,2015-02,37,0,37,-5.9090909090909065
2390,Cluster 5,2015-03,49,2,47,-7.25
2391,Cluster 5,2015-04,71,2,69,4.454545454545453
2392,Cluster 5,2015-05,58,2,56,-17.909090909090907
2393,Cluster 5,2015-06,54,2,52,-23.295454545454547
2394,Cluster 5,2015-07,77,5,72,-5.5
2395,Cluster 5,2015-08,66,2,64,-12.568181818181813
2396,Cluster 5,2015-09,65,2,63,-8.818181818181813
2397,Cluster 5,2015-10,67,6,61,-10.227272727272734
2398,Cluster 5,2015-11,62,2,60,-9.090909090909093
2399,Cluster 5,2015-12,53,2,51,-23.38636363636364
2400,Cluster 6,2011-01,162,3,159,110.77272727272728
2401,Cluster 6,2011-02,158,2,156,109.6590909090909
2402,Cluster 6,2011-03,208,4,204,149.97727272727272
2403,Cluster 6,2011-04,185,7,178,129.88636363636363
2404,Cluster 6,2011-05,180,5,175,115.72727272727273
2405,Cluster 6,2011-06,174,4,170,107.06818181818181
2406,Cluster 6,2011-07,187,5,182,118.47727272727273
2407,Cluster 6,2011-08,201,9,192,133.38636363636363
2408,Cluster 6,2011-09,156,5,151,88.63636363636364
2409,Cluster 6,2011-10,175,5,170,101.06818181818181
2410,Cluster 6,2011-11,199,6,193,130.63636363636363
2411,Cluster 6,2011-12,204,3,201,134.4318181818182
2412,Cluster 6,2012-01,191,1,190,123.54545454545455
2413,Cluster 6,2012-02,161,3,158,106.93181818181819
2414,Cluster 6,2012-03,194,7,187,137.13636363636363
2415,Cluster 6,2012-04,151,5,146,92.79545454545455
2416,Cluster 6,2012-05,176,11,165,109.43181818181819
2417,Cluster 6,2012-06,196,11,185,128.20454545454544
2418,Cluster 6,2012-07,184,9,175,110.81818181818181
2419,Cluster 6,2012-08,180,4,176,102.3409090909091
2420,Cluster 6,2012-09,166,6,160,95.8409090909091
2421,Cluster 6,2012-10,184,7,177,109.38636363636364
2422,Cluster 6,2012-11,184,4,180,118.56818181818181
2423,Cluster 6,2012-12,180,9,171,112.3409090909091
2424,Cluster 6,2013-01,184,2,182,120.27272727272728
2425,Cluster 6,2013-02,130,5,125,79.20454545454545
2426,Cluster 6,2013-03,138,3,135,79.52272727272728
2427,Cluster 6,2013-04,158,4,154,96.54545454545455
2428,Cluster 6,2013-05,162,4,158,89.63636363636364
2429,Cluster 6,2013-06,140,6,134,67.72727272727273
2430,Cluster 6,2013-07,151,3,148,78.68181818181819
2431,Cluster 6,2013-08,159,3,156,84.61363636363636
2432,Cluster 6,2013-09,154,4,150,77.88636363636364
2433,Cluster 6,2013-10,162,5,157,87.54545454545455
2434,Cluster 6,2013-11,151,8,143,84.02272727272727
2435,Cluster 6,2013-12,155,5,150,86.38636363636364
2436,Cluster 6,2014-01,166,3,163,100.97727272727273
2437,Cluster 6,2014-02,112,6,106,62.04545454545455
2438,Cluster 6,2014-03,118,6,112,62.22727272727273
2439,Cluster 6,2014-04,116,3,113,53.84090909090909
2440,Cluster 6,2014-05,132,5,127,60.13636363636364
2441,Cluster 6,2014-06,140,6,134,63.93181818181819
2442,Cluster 6,2014-07,181,5,176,96.8409090909091
2443,Cluster 6,2014-08,241,7,234,154.0
2444,Cluster 6,2014-09,200,5,195,115.88636363636364
2445,Cluster 6,2014-10,185,10,175,97.9090909090909
2446,Cluster 6,2014-11,162,5,157,86.56818181818181
2447,Cluster 6,2014-12,157,6,151,87.5
2448,Cluster 6,2015-01,133,0,133,67.72727272727273
2449,Cluster 6,2015-02,85,4,81,42.09090909090909
2450,Cluster 6,2015-03,128,5,123,71.75
2451,Cluster 6,2015-04,139,6,133,72.45454545454545
2452,Cluster 6,2015-05,157,8,149,81.0909090909091
2453,Cluster 6,2015-06,177,6,171,99.70454545454545
2454,Cluster 6,2015-07,187,7,180,104.5
2455,Cluster 6,2015-08,201,6,195,122.43181818181819
2456,Cluster 6,2015-09,176,9,167,102.18181818181819
2457,Cluster 6,2015-10,217,5,212,139.77272727272725
2458,Cluster 6,2015-11,205,5,200,133.9090909090909
2459,Cluster 6,2015-12,241,5,236,164.61363636363637
2460,Cluster 7,2011-01,60,3,57,8.772727272727273
2461,Cluster 7,2011-02,69,1,68,20.659090909090907
2462,Cluster 7,2011-03,94,4,90,35.97727272727273
2463,Cluster 7,2011-04,76,4,72,20.886363636363633
2464,Cluster 7,2011-05,86,10,76,21.727272727272734
2465,Cluster 7,2011-06,74,7,67,7.068181818181813
2466,Cluster 7,2011-07,88,2,86,19.477272727272734
2467,Cluster 7,2011-08,86,6,80,18.38636363636364
2468,Cluster 7,2011-09,73,3,70,5.63636363636364
2469,Cluster 7,2011-10,114,7,107,40.06818181818181
2470,Cluster 7,2011-11,103,4,99,34.63636363636364
2471,Cluster 7,2011-12,109,5,104,39.43181818181819
2472,Cluster 7,2012-01,99,5,94,31.545454545454547
2473,Cluster 7,2012-02,105,7,98,50.93181818181818
2474,Cluster 7,2012-03,87,1,86,30.136363636363633
2475,Cluster 7,2012-04,91,4,87,32.79545454545455
2476,Cluster 7,2012-05,102,5,97,35.43181818181819
2477,Cluster 7,2012-06,107,5,102,39.20454545454545
2478,Cluster 7,2012-07,114,4,110,40.81818181818181
2479,Cluster 7,2012-08,99,1,98,21.340909090909093
2480,Cluster 7,2012-09,114,2,112,43.84090909090909
2481,Cluster 7,2012-10,109,1,108,34.38636363636364
2482,Cluster 7,2012-11,83,1,82,17.568181818181813
2483,Cluster 7,2012-12,94,5,89,26.340909090909093
2484,Cluster 7,2013-01,91,3,88,27.272727272727273
2485,Cluster 7,2013-02,69,5,64,18.204545454545453
2486,Cluster 7,2013-03,91,2,89,32.52272727272727
2487,Cluster 7,2013-04,94,9,85,32.54545454545455
2488,Cluster 7,2013-05,87,4,83,14.63636363636364
2489,Cluster 7,2013-06,100,5,95,27.727272727272734
2490,Cluster 7,2013-07,82,3,79,9.681818181818187
2491,Cluster 7,2013-08,98,10,88,23.61363636363636
2492,Cluster 7,2013-09,91,8,83,14.88636363636364
2493,Cluster 7,2013-10,90,8,82,15.545454545454547
2494,Cluster 7,2013-11,87,6,81,20.022727272727266
2495,Cluster 7,2013-12,128,5,123,59.38636363636364
2496,Cluster 7,2014-01,92,6,86,26.977272727272734
2497,Cluster 7,2014-02,90,4,86,40.04545454545455
2498,Cluster 7,2014-03,78,3,75,22.227272727272727
2499,Cluster 7,2014-04,80,2,78,17.840909090909093
2500,Cluster 7,2014-05,94,6,88,22.13636363636364
2501,Cluster 7,2014-06,116,7,109,39.93181818181819
2502,Cluster 7,2014-07,132,4,128,47.84090909090909
2503,Cluster 7,2014-08,132,4,128,45.0
2504,Cluster 7,2014-09,117,2,115,32.88636363636364
2505,Cluster 7,2014-10,114,3,111,26.909090909090907
2506,Cluster 7,2014-11,113,6,107,37.56818181818181
2507,Cluster 7,2014-12,96,3,93,26.5
2508,Cluster 7,2015-01,103,4,99,37.727272727272734
2509,Cluster 7,2015-02,60,3,57,17.090909090909093
2510,Cluster 7,2015-03,72,2,70,15.75
2511,Cluster 7,2015-04,88,4,84,21.454545454545453
2512,Cluster 7,2015-05,112,4,108,36.09090909090909
2513,Cluster 7,2015-06,116,3,113,38.70454545454545
2514,Cluster 7,2015-07,131,8,123,48.5
2515,Cluster 7,2015-08,134,5,129,55.43181818181819
2516,Cluster 7,2015-09,113,3,110,39.18181818181819
2517,Cluster 7,2015-10,97,5,92,19.772727272727266
2518,Cluster 7,2015-11,110,6,104,38.90909090909091
2519,Cluster 7,2015-12,118,3,115,41.61363636363636
2520,Cluster 8,2011-01,157,9,148,105.77272727272728
2521,Cluster 8,2011-02,152,11,141,103.6590909090909
2522,Cluster 8,2011-03,156,5,151,97.97727272727272
2523,Cluster 8,2011-04,179,7,172,123.88636363636363
2524,Cluster 8,2011-05,137,12,125,72.72727272727273
2525,Cluster 8,2011-06,181,7,174,114.06818181818181
2526,Cluster 8,2011-07,180,17,163,111.47727272727273
2527,Cluster 8,2011-08,188,13,175,120.38636363636364
2528,Cluster 8,2011-09,192,11,181,124.63636363636364
2529,Cluster 8,2011-10,194,10,184,120.06818181818181
2530,Cluster 8,2011-11,183,7,176,114.63636363636364
2531,Cluster 8,2011-12,203,8,195,133.4318181818182
2532,Cluster 8,2012-01,209,6,203,141.54545454545456
2533,Cluster 8,2012-02,198,11,187,143.9318181818182
2534,Cluster 8,2012-03,211,8,203,154.13636363636363
2535,Cluster 8,2012-04,180,8,172,121.79545454545455
2536,Cluster 8,2012-05,185,14,171,118.43181818181819
2537,Cluster 8,2012-06,216,9,207,148.20454545454544
2538,Cluster 8,2012-07,241,11,230,167.8181818181818
2539,Cluster 8,2012-08,200,18,182,122.3409090909091
2540,Cluster 8,2012-09,175,9,166,104.8409090909091
2541,Cluster 8,2012-10,181,9,172,106.38636363636364
2542,Cluster 8,2012-11,197,5,192,131.5681818181818
2543,Cluster 8,2012-12,174,6,168,106.3409090909091
2544,Cluster 8,2013-01,160,3,157,96.27272727272728
2545,Cluster 8,2013-02,148,3,145,97.20454545454545
2546,Cluster 8,2013-03,194,5,189,135.52272727272728
2547,Cluster 8,2013-04,166,8,158,104.54545454545455
2548,Cluster 8,2013-05,222,14,208,149.63636363636363
2549,Cluster 8,2013-06,192,12,180,119.72727272727273
2550,Cluster 8,2013-07,193,11,182,120.68181818181819
2551,Cluster 8,2013-08,180,13,167,105.61363636363636
2552,Cluster 8,2013-09,184,13,171,107.88636363636364
2553,Cluster 8,2013-10,196,13,183,121.54545454545455
2554,Cluster 8,2013-11,164,11,153,97.02272727272727
2555,Cluster 8,2013-12,209,6,203,140.38636363636363
2556,Cluster 8,2014-01,168,11,157,102.97727272727273
2557,Cluster 8,2014-02,203,9,194,153.04545454545456
2558,Cluster 8,2014-03,214,6,208,158.22727272727272
2559,Cluster 8,2014-04,237,7,230,174.8409090909091
2560,Cluster 8,2014-05,238,11,227,166.13636363636363
2561,Cluster 8,2014-06,258,12,246,181.9318181818182
2562,Cluster 8,2014-07,239,10,229,154.8409090909091
2563,Cluster 8,2014-08,230,10,220,143.0
2564,Cluster 8,2014-09,208,10,198,123.88636363636364
2565,Cluster 8,2014-10,204,8,196,116.9090909090909
2566,Cluster 8,2014-11,237,6,231,161.5681818181818
2567,Cluster 8,2014-12,254,7,247,184.5
2568,Cluster 8,2015-01,222,7,215,156.72727272727275
2569,Cluster 8,2015-02,138,6,132,95.0909090909091
2570,Cluster 8,2015-03,163,13,150,106.75
2571,Cluster 8,2015-04,180,12,168,113.45454545454545
2572,Cluster 8,2015-05,171,14,157,95.0909090909091
2573,Cluster 8,2015-06,181,7,174,103.70454545454545
2574,Cluster 8,2015-07,189,13,176,106.5
2575,Cluster 8,2015-08,249,14,235,170.4318181818182
2576,Cluster 8,2015-09,222,13,209,148.1818181818182
2577,Cluster 8,2015-10,285,14,271,207.77272727272725
2578,Cluster 8,2015-11,264,9,255,192.9090909090909
2579,Cluster 8,2015-12,264,12,252,187.61363636363637
2580,Cluster 9,2011-01,37,3,34,-14.227272727272727
2581,Cluster 9,2011-02,41,6,35,-7.3409090909090935
2582,Cluster 9,2011-03,29,7,22,-29.022727272727273
2583,Cluster 9,2011-04,31,2,29,-24.113636363636367
2584,Cluster 9,2011-05,55,4,51,-9.272727272727266
2585,Cluster 9,2011-06,47,4,43,-19.931818181818187
2586,Cluster 9,2011-07,56,5,51,-12.522727272727266
2587,Cluster 9,2011-08,55,1,54,-12.61363636363636
2588,Cluster 9,2011-09,55,7,48,-12.36363636363636
2589,Cluster 9,2011-10,47,7,40,-26.931818181818187
2590,Cluster 9,2011-11,50,2,48,-18.36363636363636
2591,Cluster 9,2011-12,53,3,50,-16.568181818181813
2592,Cluster 9,2012-01,46,0,46,-21.454545454545453
2593,Cluster 9,2012-02,35,3,32,-19.06818181818182
2594,Cluster 9,2012-03,27,5,22,-29.863636363636367
2595,Cluster 9,2012-04,38,4,34,-20.204545454545453
2596,Cluster 9,2012-05,45,3,42,-21.568181818181813
2597,Cluster 9,2012-06,49,1,48,-18.795454545454547
2598,Cluster 9,2012-07,84,9,75,10.818181818181813
2599,Cluster 9,2012-08,53,7,46,-24.659090909090907
2600,Cluster 9,2012-09,55,5,50,-15.159090909090907
2601,Cluster 9,2012-10,53,3,50,-21.61363636363636
2602,Cluster 9,2012-11,54,0,54,-11.431818181818187
2603,Cluster 9,2012-12,47,1,46,-20.659090909090907
2604,Cluster 9,2013-01,43,2,41,-20.727272727272727
2605,Cluster 9,2013-02,33,2,31,-17.795454545454547
2606,Cluster 9,2013-03,46,5,41,-12.477272727272727
2607,Cluster 9,2013-04,41,6,35,-20.454545454545453
2608,Cluster 9,2013-05,51,3,48,-21.36363636363636
2609,Cluster 9,2013-06,62,4,58,-10.272727272727266
2610,Cluster 9,2013-07,71,3,68,-1.318181818181813
2611,Cluster 9,2013-08,66,10,56,-8.38636363636364
2612,Cluster 9,2013-09,64,8,56,-12.11363636363636
2613,Cluster 9,2013-10,50,3,47,-24.454545454545453
2614,Cluster 9,2013-11,46,8,38,-20.977272727272734
2615,Cluster 9,2013-12,48,3,45,-20.61363636363636
2616,Cluster 9,2014-01,42,5,37,-23.022727272727266
2617,Cluster 9,2014-02,46,2,44,-3.9545454545454533
2618,Cluster 9,2014-03,43,2,41,-12.772727272727273
2619,Cluster 9,2014-04,44,2,42,-18.159090909090907
2620,Cluster 9,2014-05,52,5,47,-19.86363636363636
2621,Cluster 9,2014-06,50,10,40,-26.068181818181813
2622,Cluster 9,2014-07,53,6,47,-31.159090909090907
2623,Cluster 9,2014-08,44,3,41,-43.0
2624,Cluster 9,2014-09,58,5,53,-26.11363636363636
2625,Cluster 9,2014-10,50,2,48,-37.09090909090909
2626,Cluster 9,2014-11,49,0,49,-26.431818181818187
2627,Cluster 9,2014-12,38,4,34,-31.5
2628,Cluster 9,2015-01,39,2,37,-26.272727272727266
2629,Cluster 9,2015-02,30,1,29,-12.909090909090907
2630,Cluster 9,2015-03,30,4,26,-26.25
2631,Cluster 9,2015-04,40,4,36,-26.545454545454547
2632,Cluster 9,2015-05,55,4,51,-20.909090909090907
2633,Cluster 9,2015-06,42,2,40,-35.29545454545455
2634,Cluster 9,2015-07,52,6,46,-30.5
2635,Cluster 9,2015-08,74,6,68,-4.568181818181813
2636,Cluster 9,2015-09,64,3,61,-9.818181818181813
2637,Cluster 9,2015-10,56,1,55,-21.227272727272734
2638,Cluster 9,2015-11,65,10,55,-6.0909090909090935
2639,Cluster 9,2015-12,59,6,53,-17.38636363636364
